tax	1M	4H	5H	6H	6M	7H	7M	total
Bacteria;Bacteria_none;Firmicutes;Clostridia;Clostridiales;Clostridiaceae;Clostridium sensu stricto 1	110153	13801	135750	5178	31509	79732	109428	485551
Bacteria;Bacteria_none;Proteobacteria;Gammaproteobacteria;Pseudomonadales;Halieaceae;OM60(NOR5) clade	52475	615	735	1827	24519	44071	70544	194786
Bacteria;Bacteria_none;Proteobacteria;Gammaproteobacteria;Enterobacterales;Psychromonadaceae;Psychromonas	134	97644	5330	688	172	372	59821	164161
Bacteria;Bacteria_none;Proteobacteria;Gammaproteobacteria;Pseudomonadales;Moraxellaceae;Psychrobacter	61649	740	428	69827	193	913	5992	139742
Bacteria;Bacteria_none;Campylobacterota;Campylobacteria;Campylobacterales;Arcobacteraceae;Arcobacteraceae_uncultured	2626	44911	2605	12073	994	7310	4268	74787
Bacteria;Bacteria_none;Proteobacteria;Gammaproteobacteria;Enterobacterales;Colwelliaceae;Colwellia	1922	8412	603	5304	369	3353	2208	22171
Bacteria;Bacteria_none;Proteobacteria;Gammaproteobacteria;Enterobacterales;Pseudoalteromonadaceae;Pseudoalteromonas	8216	19	119	10076	7	109	579	19125
Bacteria;Bacteria_none;Proteobacteria;Gammaproteobacteria;Pseudomonadales;Halieaceae;Congregibacter	6899	156	0	1	3646	5717	2519	18938
Bacteria;Bacteria_none;Proteobacteria;Gammaproteobacteria;Pseudomonadales;Halieaceae;Halioglobus	3754	1611	544	305	1506	3239	7717	18676
Bacteria;Bacteria_none;Firmicutes;Bacilli;Entomoplasmatales;Entomoplasmatales Incertae Sedis;Candidatus Hepatoplasma	8313	97	4901	1	75	1764	142	15293
Bacteria;Bacteria_none;Bacteroidota;Bacteroidia;Flavobacteriales;Flavobacteriaceae;Mesonia	3132	0	1	10623	1	1	235	13993
Bacteria;Bacteria_none;Proteobacteria;Gammaproteobacteria;Enterobacterales;Yersiniaceae;Serratia	301	0	1	24	0	0	10903	11229
Bacteria;Bacteria_none;Proteobacteria;Gammaproteobacteria;Pseudomonadales;Nitrincolaceae;Profundimonas	557	57	126	7815	80	761	524	9920
Bacteria;Bacteria_none;Proteobacteria;Gammaproteobacteria;Pseudomonadales;Pseudomonadaceae;Pseudomonas	1868	149	72	145	1591	1687	2371	7883
Bacteria;Bacteria_none;Firmicutes;Clostridia;Peptostreptococcales-Tissierellales;Peptostreptococcales-Tissierellales_Incertae_sedis;Gottschalkia	387	243	1	0	91	3154	430	4306
Bacteria;Bacteria_none;Planctomycetota;Planctomycetes;Pirellulales;Pirellulaceae;Blastopirellula	553	146	20	0	240	460	2263	3682
Bacteria;Bacteria_none;Proteobacteria;Alphaproteobacteria;Rhodobacterales;Rhodobacteraceae;Rhodobacteraceae_uncultured	936	1001	21	3	492	336	891	3680
Bacteria;Bacteria_none;Proteobacteria;Gammaproteobacteria;Enterobacterales;Vibrionaceae;Vibrio	799	59	61	1253	0	7	855	3034
Bacteria;Bacteria_none;Bacteroidota;Bacteroidia;Flavobacteriales;Flavobacteriaceae;Tenacibaculum	110	124	0	1802	83	411	104	2634
Bacteria;Bacteria_none;Proteobacteria;Gammaproteobacteria;Pseudomonadales;Marinomonadaceae;Marinomonas	486	1	124	1602	10	28	176	2427
Bacteria;Bacteria_none;Proteobacteria;Gammaproteobacteria;Nitrosococcales;Methylophagaceae;Methylophagaceae_uncultured	188	367	307	912	33	213	350	2370
Bacteria;Bacteria_none;Proteobacteria;Alphaproteobacteria;Rhodobacterales;Rhodobacteraceae;Roseovarius	607	20	3	1325	10	105	33	2103
Bacteria;Bacteria_none;Proteobacteria;Gammaproteobacteria;Pseudomonadales;Halomonadaceae;Cobetia	306	0	0	1472	0	0	16	1794
Bacteria;Bacteria_none;Firmicutes;Clostridia;Peptostreptococcales-Tissierellales;Peptostreptococcaceae;Romboutsia	474	0	15	0	350	769	181	1789
Bacteria;Bacteria_none;Firmicutes;Bacilli;Lactobacillales;Carnobacteriaceae;Carnobacterium	147	150	61	997	0	90	331	1776
Bacteria;Bacteria_none;Verrucomicrobiota;Verrucomicrobiae;Verrucomicrobiales;Rubritaleaceae;Rubritalea	517	331	0	0	102	381	330	1661
Bacteria;Bacteria_none;Proteobacteria;Gammaproteobacteria;Enterobacterales;Enterobacteriaceae;Escherichia-Shigella	837	123	85	373	34	93	101	1646
Bacteria;Bacteria_none;Bacteroidota;Bacteroidia;Cytophagales;Cyclobacteriaceae;Cyclobacteriaceae_uncultured	101	0	0	1366	20	101	52	1640
Bacteria;Bacteria_none;Verrucomicrobiota;Verrucomicrobiae;Opitutales;Puniceicoccaceae;Lentimonas	278	0	0	590	94	635	38	1635
Bacteria;Bacteria_none;Planctomycetota;Planctomycetes;Pirellulales;Pirellulaceae;Rubripirellula	412	264	44	0	92	74	428	1314
Bacteria;Bacteria_none;Firmicutes;Clostridia;Clostridiales;Clostridiaceae;Sarcina	331	26	44	1	197	416	263	1278
Bacteria;Bacteria_none;Verrucomicrobiota;Verrucomicrobiae;Verrucomicrobiales;Rubritaleaceae;Persicirhabdus	235	35	0	0	112	484	349	1215
Bacteria;Bacteria_none;Bacteroidota;Bacteroidia;Flavobacteriales;Flavobacteriaceae;Lacinutrix	180	24	0	584	9	310	103	1210
Bacteria;Bacteria_none;Proteobacteria;Alphaproteobacteria;Rhodobacterales;Rhodobacteraceae;Sulfitobacter	647	133	38	6	117	127	116	1184
Bacteria;Bacteria_none;Proteobacteria;Gammaproteobacteria;Pseudomonadales;Nitrincolaceae;Motiliproteus	111	3	18	733	15	126	119	1125
Bacteria;Bacteria_none;Proteobacteria;Gammaproteobacteria;Pseudomonadales;Halieaceae;Parahaliea	233	11	22	39	79	141	533	1058
Bacteria;Bacteria_none;Firmicutes;Bacilli;Bacillales;Planococcaceae;Planococcus	68	0	0	948	0	0	0	1016
Bacteria;Bacteria_none;Bacteroidota;Bacteroidia;Flavobacteriales;Flavobacteriaceae;Polaribacter	199	18	13	55	69	316	346	1016
Bacteria;Bacteria_none;Planctomycetota;Planctomycetes;Pirellulales;Pirellulaceae;Rhodopirellula	46	287	73	0	55	275	257	993
Bacteria;Bacteria_none;Firmicutes;Clostridia;Clostridiales;Clostridiaceae;Clostridium sensu stricto 13	65	207	9	0	107	401	202	991
Bacteria;Bacteria_none;Campylobacterota;Campylobacteria;Campylobacterales;Sulfurovaceae;Sulfurovum	78	0	0	0	38	814	22	952
Bacteria;Bacteria_none;Proteobacteria;Gammaproteobacteria;Pseudomonadales;Moraxellaceae;Paraperlucidibaca	208	0	36	3	130	257	310	944
Bacteria;Bacteria_none;Proteobacteria;Gammaproteobacteria;Pseudomonadales;Halomonadaceae;Halomonas	504	8	3	239	40	30	108	932
Bacteria;Bacteria_none;Planctomycetota;Planctomycetes;Pirellulales;Pirellulaceae;Pir4 lineage	25	384	0	0	56	117	349	931
Bacteria;Bacteria_none;Bacteroidota;Bacteroidia;Flavobacteriales;Flavobacteriaceae;Ulvibacter	156	9	11	258	87	257	93	871
Bacteria;Bacteria_none;Proteobacteria;Gammaproteobacteria;Enterobacterales;Moritellaceae;Moritella	5	41	673	2	1	64	55	841
Bacteria;Bacteria_none;Proteobacteria;Gammaproteobacteria;Pseudomonadales;Halieaceae;Chromatocurvus	193	5	7	28	64	129	377	803
Bacteria;Bacteria_none;Firmicutes;Clostridia;Lachnospirales;Lachnospiraceae;Lachnospiraceae_uncultured	122	15	20	0	75	452	89	773
Bacteria;Bacteria_none;Bacteroidota;Bacteroidia;Flavobacteriales;Flavobacteriaceae;Pseudofulvibacter	159	213	0	101	10	183	105	771
Bacteria;Bacteria_none;Proteobacteria;Alphaproteobacteria;Rhodobacterales;Rhodobacteraceae;Paracoccus	350	32	4	205	31	66	82	770
Bacteria;Bacteria_none;Bacteroidota;Bacteroidia;Flavobacteriales;Flavobacteriaceae;Flavobacteriaceae_uncultured	84	44	26	214	62	213	125	768
Bacteria;Bacteria_none;Firmicutes;Clostridia;Peptostreptococcales-Tissierellales;Family XI;Tissierella	40	0	0	0	36	649	41	766
Bacteria;Bacteria_none;Proteobacteria;Gammaproteobacteria;Enterobacterales;Enterobacteriaceae;Klebsiella	250	0	0	384	79	0	43	756
Bacteria;Bacteria_none;Firmicutes;Clostridia;Peptococcales;Peptococcaceae;Peptococcus	381	0	13	0	72	214	72	752
Bacteria;Bacteria_none;Proteobacteria;Gammaproteobacteria;Burkholderiales;Nitrosomonadaceae;IS-44	76	481	22	0	34	0	104	717
Bacteria;Bacteria_none;Bacteroidota;Bacteroidia;Flavobacteriales;Flavobacteriaceae;Arenibacter	83	0	19	415	8	98	68	691
Bacteria;Bacteria_none;Proteobacteria;Gammaproteobacteria;Pseudomonadales;Halieaceae;Pseudohaliea	174	16	7	19	58	100	316	690
Bacteria;Bacteria_none;Actinobacteriota;Actinobacteria;Propionibacteriales;Propionibacteriaceae;Tessaracoccus	90	0	0	0	34	517	32	673
Bacteria;Bacteria_none;Proteobacteria;Alphaproteobacteria;Rhodobacterales;Rhodobacteraceae;Lacimonas	54	58	4	0	62	366	126	670
Bacteria;Bacteria_none;Proteobacteria;Gammaproteobacteria;Pseudomonadales;Halieaceae;Marimicrobium	94	181	14	15	41	53	271	669
Bacteria;Bacteria_none;Proteobacteria;Gammaproteobacteria;Steroidobacterales;Woeseiaceae;Woeseia	191	36	4	1	99	218	88	637
Bacteria;Bacteria_none;Firmicutes;Clostridia;Lachnospirales;Lachnospiraceae;Tyzzerella	1	0	0	0	23	519	83	626
Bacteria;Bacteria_none;Proteobacteria;Alphaproteobacteria;SAR11 clade;Clade I;Clade Ia	207	311	0	0	53	24	14	609
Bacteria;Bacteria_none;Proteobacteria;Gammaproteobacteria;Pseudomonadales;Spongiibacteraceae;BD1-7 clade	160	2	0	2	129	157	158	608
Bacteria;Bacteria_none;Verrucomicrobiota;Verrucomicrobiae;Verrucomicrobiales;Rubritaleaceae;Roseibacillus	61	114	0	0	29	136	267	607
Bacteria;Bacteria_none;Firmicutes;Clostridia;Oscillospirales;Ruminococcaceae;Ruminococcus	0	0	0	571	0	2	12	585
Bacteria;Bacteria_none;Bacteroidota;Bacteroidia;Flavobacteriales;Flavobacteriaceae;Flavobacterium	90	28	3	102	51	210	96	580
Bacteria;Bacteria_none;Proteobacteria;Gammaproteobacteria;Enterobacterales;Shewanellaceae;Shewanella	209	1	66	109	15	0	168	568
Bacteria;Bacteria_none;Proteobacteria;Gammaproteobacteria;Pseudomonadales;Moraxellaceae;Acinetobacter	263	4	11	73	25	43	145	564
Bacteria;Bacteria_none;Bacteroidota;Bacteroidia;Flavobacteriales;Flavobacteriaceae;Winogradskyella	203	39	0	112	37	31	136	558
Bacteria;Bacteria_none;Firmicutes;Bacilli;Bacillales;Planococcaceae;Sporosarcina	1	0	0	17	7	470	41	536
Bacteria;Bacteria_none;Desulfobacterota;Desulfobulbia;Desulfobulbales;Desulfocapsaceae;Desulforhopalus	146	22	6	0	41	129	189	533
Bacteria;Bacteria_none;Bacteroidota;Bacteroidia;Flavobacteriales;Flavobacteriaceae;Arcticiflavibacter	0	0	0	451	0	0	79	530
Bacteria;Bacteria_none;Proteobacteria;Gammaproteobacteria;Enterobacterales;Enterobacteriaceae;Salmonella	381	0	0	80	0	32	37	530
Bacteria;Bacteria_none;Proteobacteria;Gammaproteobacteria;Gammaproteobacteria Incertae Sedis;Unknown Family;Unknown Family_uncultured	106	83	58	1	62	63	151	524
Bacteria;Bacteria_none;Desulfobacterota;Desulfobulbia;Desulfobulbales;Desulfocapsaceae;Desulfocapsaceae_uncultured	7	55	31	0	53	227	139	512
Bacteria;Bacteria_none;Firmicutes;Clostridia;Peptostreptococcales-Tissierellales;Peptostreptococcaceae;[Eubacterium] tenue group	184	0	0	0	27	179	118	508
Bacteria;Bacteria_none;Firmicutes;Bacilli;Lactobacillales;Carnobacteriaceae;Granulicatella	384	0	0	0	34	0	78	496
Bacteria;Bacteria_none;Fusobacteriota;Fusobacteriia;Fusobacteriales;Fusobacteriaceae;Psychrilyobacter	0	286	135	0	0	0	51	472
Bacteria;Bacteria_none;Proteobacteria;Gammaproteobacteria;Pseudomonadales;Halieaceae;Haliea	104	5	6	23	32	98	200	468
Bacteria;Bacteria_none;Actinobacteriota;Acidimicrobiia;Microtrichales;Ilumatobacteraceae;Ilumatobacter	49	31	13	0	28	172	159	452
Bacteria;Bacteria_none;Proteobacteria;Gammaproteobacteria;Pseudomonadales;Alcanivoracaceae1;Alcanivorax	109	0	3	16	82	84	147	441
Bacteria;Bacteria_none;Bdellovibrionota;Oligoflexia;Oligoflexales;Oligoflexaceae;Oligoflexaceae_uncultured	55	275	0	0	47	1	51	429
Bacteria;Bacteria_none;Actinobacteriota;Actinobacteria;Propionibacteriales;Propionibacteriaceae;Cutibacterium	14	10	0	400	0	0	0	424
Bacteria;Bacteria_none;Proteobacteria;Gammaproteobacteria;Enterobacterales;Enterobacteriaceae;Enterobacter	258	59	0	78	0	0	27	422
Bacteria;Bacteria_none;Firmicutes;Bacilli;Staphylococcales;Staphylococcaceae;Staphylococcus	62	0	0	340	0	0	9	411
Bacteria;Bacteria_none;Firmicutes;Clostridia;Christensenellales;Christensenellaceae;Christensenellaceae R-7 group	52	0	43	0	12	189	103	399
Bacteria;Bacteria_none;Proteobacteria;Gammaproteobacteria;Pseudomonadales;Nitrincolaceae;Nitrincola	121	1	2	1	26	45	195	391
Bacteria;Bacteria_none;Proteobacteria;Gammaproteobacteria;Pseudomonadales;Pseudohongiellaceae;Pseudohongiella	38	0	0	211	26	39	76	390
Bacteria;Bacteria_none;Proteobacteria;Alphaproteobacteria;Rhizobiales;Methyloligellaceae;Methyloceanibacter	0	239	0	0	43	32	70	384
Bacteria;Bacteria_none;Firmicutes;Clostridia;Peptostreptococcales-Tissierellales;Peptostreptococcaceae;Terrisporobacter	51	0	92	0	19	209	9	380
Bacteria;Bacteria_none;Proteobacteria;Gammaproteobacteria;Pseudomonadales;Marinobacteraceae;Marinobacter	261	7	0	20	17	21	46	372
Bacteria;Bacteria_none;Proteobacteria;Gammaproteobacteria;Burkholderiales;Gallionellaceae;Candidatus Nitrotoga	0	0	0	371	0	0	0	371
Bacteria;Bacteria_none;Bacteroidota;Bacteroidia;Flavobacteriales;Flavobacteriaceae;Formosa	13	1	0	179	5	108	62	368
Bacteria;Bacteria_none;Verrucomicrobiota;Verrucomicrobiae;Verrucomicrobiales;Rubritaleaceae;Haloferula	119	20	0	0	32	0	176	347
Bacteria;Bacteria_none;Proteobacteria;Gammaproteobacteria;Thiotrichales;Thiotrichaceae;Cocleimonas	72	95	83	0	8	79	4	341
Bacteria;Bacteria_none;Proteobacteria;Gammaproteobacteria;Enterobacterales;Alteromonadaceae;Alteromonas	192	0	1	119	11	2	10	335
Bacteria;Bacteria_none;Firmicutes;Bacilli;Lactobacillales;Carnobacteriaceae;Alkalibacterium	330	0	0	0	0	0	0	330
Bacteria;Bacteria_none;Bacteroidota;Bacteroidia;Flavobacteriales;Flavobacteriaceae;NS5 marine group	2	2	0	299	1	10	13	327
Bacteria;Bacteria_none;Firmicutes;Clostridia;Oscillospirales;Oscillospiraceae;Oscillospiraceae_uncultured	169	0	0	0	0	148	0	317
Bacteria;Bacteria_none;Proteobacteria;Gammaproteobacteria;Enterobacterales;Aeromonadaceae;Aeromonas	178	7	5	65	19	16	18	308
Bacteria;Bacteria_none;Firmicutes;Bacilli;Bacillales;Bacillaceae;Bacillaceae_uncultured	36	0	0	0	2	56	207	301
Bacteria;Bacteria_none;Firmicutes;Bacilli;Lactobacillales;Carnobacteriaceae;Jeotgalibaca	0	0	0	2	0	226	53	281
Bacteria;Bacteria_none;Proteobacteria;Alphaproteobacteria;Rhodobacterales;Rhodobacteraceae;Roseobacter clade NAC11-7 lineage	10	142	1	1	7	48	72	281
Bacteria;Bacteria_none;Proteobacteria;Gammaproteobacteria;Enterobacterales;Pasteurellaceae;Haemophilus	25	0	0	40	7	189	2	263
Bacteria;Bacteria_none;Bacteroidota;Bacteroidia;Flavobacteriales;Flavobacteriaceae;Salegentibacter	240	0	0	8	2	7	4	261
Bacteria;Bacteria_none;Firmicutes;Clostridia;Peptostreptococcales-Tissierellales;Fusibacteraceae;Fusibacter	8	18	166	0	2	67	0	261
Bacteria;Bacteria_none;Proteobacteria;Gammaproteobacteria;Pseudomonadales;Alcanivoracaceae;Ketobacter	33	82	11	0	25	84	23	258
Bacteria;Bacteria_none;Proteobacteria;Alphaproteobacteria;Rhodobacterales;Rhodobacteraceae;Ruegeria	90	25	0	1	50	63	25	254
Bacteria;Bacteria_none;Proteobacteria;Gammaproteobacteria;Pseudomonadales;Saccharospirillaceae;Oleispira	6	0	64	1	3	3	176	253
Bacteria;Bacteria_none;Proteobacteria;Gammaproteobacteria;Pseudomonadales;Microbulbiferaceae;Microbulbifer	118	43	4	1	6	5	76	253
Bacteria;Bacteria_none;Proteobacteria;Gammaproteobacteria;Pseudomonadales;Moraxellaceae;Moraxella	102	2	0	23	22	25	76	250
Bacteria;Bacteria_none;Proteobacteria;Alphaproteobacteria;Rhizobiales;Rhizobiaceae;Pseudahrensia	87	38	0	0	24	0	101	250
Bacteria;Bacteria_none;Proteobacteria;Alphaproteobacteria;Rhodobacterales;Rhodobacteraceae;Ascidiaceihabitans	33	179	0	0	4	9	22	247
Bacteria;Bacteria_none;Proteobacteria;Gammaproteobacteria;Pseudomonadales;Cellvibrionaceae;Cellvibrionaceae_uncultured	35	1	47	0	32	77	53	245
Bacteria;Bacteria_none;Proteobacteria;Alphaproteobacteria;Rhizobiales;Xanthobacteraceae;Xanthobacteraceae_uncultured	8	29	0	0	0	0	199	236
Bacteria;Bacteria_none;Firmicutes;Clostridia;Peptostreptococcales-Tissierellales;Peptostreptococcaceae;Paraclostridium	67	0	13	0	21	102	29	232
Bacteria;Bacteria_none;Desulfobacterota;Desulfobulbia;Desulfobulbales;Desulfocapsaceae;SEEP-SRB4	44	3	0	0	39	40	96	222
Bacteria;Bacteria_none;Planctomycetota;Planctomycetes;Pirellulales;Pirellulaceae;Pirellulaceae_uncultured	2	85	15	0	7	74	35	218
Bacteria;Bacteria_none;Firmicutes;Bacilli;Lactobacillales;Streptococcaceae;Streptococcus	199	0	0	1	0	0	14	214
Bacteria;Bacteria_none;Proteobacteria;Alphaproteobacteria;Rhizobiales;Hyphomicrobiaceae;Filomicrobium	107	0	0	0	11	0	96	214
Bacteria;Bacteria_none;Firmicutes;Clostridia;Peptostreptococcales-Tissierellales;Peptostreptococcaceae;Clostridioides	13	0	1	0	11	180	7	212
Bacteria;Bacteria_none;Firmicutes;Clostridia;Oscillospirales;Oscillospiraceae;UCG-005	73	0	0	0	32	106	1	212
Bacteria;Bacteria_none;Proteobacteria;Alphaproteobacteria;Rhodobacterales;Rhodobacteraceae;Tropicimonas	58	59	0	0	41	43	9	210
Bacteria;Bacteria_none;Firmicutes;Bacilli;Bacillales;Planococcaceae;Planomicrobium	5	0	0	204	0	0	0	209
Bacteria;Bacteria_none;Firmicutes;Bacilli;Lactobacillales;Carnobacteriaceae;Atopostipes	56	0	0	1	0	139	11	207
Bacteria;Bacteria_none;Proteobacteria;Gammaproteobacteria;Enterobacterales;Vibrionaceae;Photobacterium	7	76	0	15	0	52	51	201
Bacteria;Bacteria_none;Proteobacteria;Gammaproteobacteria;Pseudomonadales;Thioglobaceae;SUP05 cluster	49	2	2	7	48	31	62	201
Bacteria;Bacteria_none;Firmicutes;Clostridia;Clostridiales;Clostridiaceae;Clostridium sensu stricto 7	34	5	86	0	19	12	45	201
Bacteria;Bacteria_none;Proteobacteria;Gammaproteobacteria;Legionellales;Legionellaceae;Legionellaceae_uncultured	0	25	27	0	28	0	121	201
Bacteria;Bacteria_none;Proteobacteria;Alphaproteobacteria;Rhodobacterales;Rhodobacteraceae;Litoreibacter	72	13	0	0	56	45	13	199
Bacteria;Bacteria_none;Firmicutes;Bacilli;Lactobacillales;Vagococcaceae;Vagococcus	176	0	0	0	0	0	16	192
Bacteria;Bacteria_none;Desulfobacterota;Desulfobulbia;Desulfobulbales;Desulfobulbaceae;Desulfobulbus	73	0	0	0	10	53	50	186
Unclassified;Unknown;Unknown;Unknown;Unknown;Unknown;Unknown	21	25	5	46	4	71	12	184
Bacteria;Bacteria_none;Bacteroidota;Bacteroidia;Flavobacteriales;Crocinitomicaceae;Fluviicola	13	69	0	0	5	80	17	184
Bacteria;Bacteria_none;Proteobacteria;Gammaproteobacteria;Pseudomonadales;Thioglobaceae;IheB2-31	184	0	0	0	0	0	0	184
Bacteria;Bacteria_none;Proteobacteria;Alphaproteobacteria;Rhodobacterales;Rhodobacteraceae;Phaeobacter	126	0	7	0	19	0	27	179
Bacteria;Bacteria_none;Bacteroidota;Bacteroidia;Flavobacteriales;Flavobacteriaceae;Lutimonas	1	20	0	0	36	42	78	177
Bacteria;Bacteria_none;Proteobacteria;Gammaproteobacteria;Pseudomonadales;Pseudohongiellaceae;BIyi10	38	4	3	3	13	28	88	177
Bacteria;Bacteria_none;Firmicutes;Bacilli;Erysipelotrichales;Erysipelotrichaceae;Catenisphaera	110	0	0	0	2	0	59	171
Bacteria;Bacteria_none;Planctomycetota;Planctomycetes;Planctomycetales;Gimesiaceae;Gimesiaceae_uncultured	29	46	0	0	11	84	1	171
Bacteria;Bacteria_none;Firmicutes;Bacilli;Lactobacillales;Aerococcaceae;Facklamia	170	0	0	0	0	0	0	170
Bacteria;Bacteria_none;Bacteroidota;Bacteroidia;Bacteroidales;Porphyromonadaceae;Porphyromonas	0	0	0	167	1	0	0	168
Bacteria;Bacteria_none;Proteobacteria;Gammaproteobacteria;Coxiellales;Coxiellaceae;Coxiella	3	33	0	0	25	63	40	164
Bacteria;Bacteria_none;Firmicutes;Clostridia;Oscillospirales;Hungateiclostridiaceae;Hungateiclostridiaceae_uncultured	0	0	0	0	4	157	1	162
Bacteria;Bacteria_none;Bacteroidota;Bacteroidia;Flavobacteriales;Cryomorphaceae;Vicingus	51	56	0	0	7	32	9	155
Bacteria;Bacteria_none;Verrucomicrobiota;Verrucomicrobiae;Verrucomicrobiales;Rubritaleaceae;Luteolibacter	1	0	26	0	8	46	74	155
Bacteria;Bacteria_none;Firmicutes;Bacilli;Bacillales;Bacillaceae;Bacillus	36	0	0	85	0	23	10	154
Bacteria;Bacteria_none;Proteobacteria;Gammaproteobacteria;Pseudomonadales;Nitrincolaceae;Marinobacterium	49	1	1	39	9	5	47	151
Bacteria;Bacteria_none;Proteobacteria;Gammaproteobacteria;Pseudomonadales;Unknown Family;Alkalimarinus	43	2	1	4	9	17	74	150
Bacteria;Bacteria_none;Bacteroidota;Bacteroidia;Flavobacteriales;Cryomorphaceae;Cryomorphaceae_uncultured	0	0	52	0	3	14	81	150
Bacteria;Bacteria_none;Bacteroidota;Bacteroidia;Flavobacteriales;Crocinitomicaceae;Crocinitomix	32	10	30	0	0	39	37	148
Bacteria;Bacteria_none;Proteobacteria;Gammaproteobacteria;Enterobacterales;Colwelliaceae;Colwelliaceae_uncultured	8	49	22	32	0	5	29	145
Bacteria;Bacteria_none;Acidobacteriota;Thermoanaerobaculia;Thermoanaerobaculales;Thermoanaerobaculaceae;Subgroup 10	0	0	0	0	44	78	23	145
Bacteria;Bacteria_none;Proteobacteria;Gammaproteobacteria;Pseudomonadales;Halieaceae;Luminiphilus	20	0	1	1	27	29	65	143
Bacteria;Bacteria_none;Spirochaetota;Spirochaetia;Spirochaetales;Spirochaetaceae;Spirochaeta 2	54	10	0	0	16	58	0	138
Bacteria;Bacteria_none;Bacteroidota;Bacteroidia;Flavobacteriales;Flavobacteriaceae;Aurantivirga	21	0	6	58	0	21	31	137
Bacteria;Bacteria_none;Actinobacteriota;Acidimicrobiia;Microtrichales;Microtrichaceae;Sva0996 marine group	8	37	0	0	14	48	22	129
Bacteria;Bacteria_none;Proteobacteria;Gammaproteobacteria;Pseudomonadales;Porticoccaceae;C1-B045	24	0	8	0	20	21	56	129
Bacteria;Bacteria_none;Firmicutes;Clostridia;Peptostreptococcales-Tissierellales;Peptostreptococcaceae;Paeniclostridium	48	0	2	0	25	40	13	128
Bacteria;Bacteria_none;Planctomycetota;Planctomycetes;Planctomycetales;Rubinisphaeraceae;Rubinisphaeraceae_uncultured	0	79	1	0	8	0	40	128
Bacteria;Bacteria_none;Proteobacteria;Gammaproteobacteria;Pseudomonadales;Spongiibacteraceae;Spongiibacteraceae_uncultured	29	0	0	0	18	22	59	128
Bacteria;Bacteria_none;Desulfobacterota;Desulfobacteria;Desulfobacterales;Desulfosarcinaceae;Sva0081 sediment group	0	1	7	0	18	61	38	125
Bacteria;Bacteria_none;Firmicutes;Clostridia;Peptostreptococcales-Tissierellales;Peptostreptococcaceae;Peptoclostridium	72	0	1	0	11	31	8	123
Bacteria;Bacteria_none;Proteobacteria;Alphaproteobacteria;Rhodobacterales;Rhodobacteraceae;Marivita	4	109	0	0	1	4	4	122
Bacteria;Bacteria_none;Bacteroidota;Bacteroidia;Flavobacteriales;Flavobacteriaceae;Bizionia	32	6	0	1	0	2	80	121
Bacteria;Bacteria_none;Proteobacteria;Gammaproteobacteria;Thiohalorhabdales;Thiohalorhabdaceae;Thiohalorhabdaceae_uncultured	48	20	0	0	19	10	23	120
Bacteria;Bacteria_none;Proteobacteria;Gammaproteobacteria;Pseudomonadales;Nitrincolaceae;Nitrincolaceae_uncultured	0	2	33	5	15	6	56	117
Bacteria;Bacteria_none;Bacteroidota;Bacteroidia;Bacteroidales;Prevotellaceae;Alloprevotella	116	0	0	0	0	0	0	116
Bacteria;Bacteria_none;Bacteroidota;Bacteroidia;Flavobacteriales;Flavobacteriaceae;Meridianimaribacter	0	0	0	0	0	116	0	116
Bacteria;Bacteria_none;Bacteroidota;Bacteroidia;Bacteroidales;Rikenellaceae;Rikenellaceae RC9 gut group	116	0	0	0	0	0	0	116
Bacteria;Bacteria_none;Chloroflexi;Anaerolineae;Caldilineales;Caldilineaceae;Caldilineaceae_uncultured	48	6	0	0	1	34	22	111
Bacteria;Bacteria_none;Proteobacteria;Gammaproteobacteria;Pseudomonadales;Moraxellaceae;Enhydrobacter	36	0	0	7	16	14	38	111
Bacteria;Bacteria_none;Proteobacteria;Gammaproteobacteria;Xanthomonadales;Xanthomonadaceae;Stenotrophomonas	46	6	0	3	34	14	7	110
Bacteria;Bacteria_none;Desulfobacterota;Desulfobulbia;Desulfobulbales;Desulfocapsaceae;Desulfopila	27	51	0	0	3	0	29	110
Bacteria;Bacteria_none;Proteobacteria;Alphaproteobacteria;Acetobacterales;Acetobacteraceae;Roseomonas	0	0	0	0	0	105	1	106
Bacteria;Bacteria_none;Proteobacteria;Alphaproteobacteria;Rhodobacterales;Rhodobacteraceae;Sedimentitalea	27	2	1	0	25	3	40	98
Bacteria;Bacteria_none;Proteobacteria;Alphaproteobacteria;Rickettsiales;Rickettsiaceae;Candidatus Megaira	0	97	0	0	0	0	0	97
Bacteria;Bacteria_none;Proteobacteria;Gammaproteobacteria;Pseudomonadales;Endozoicomonadaceae;Endozoicomonas	19	9	0	10	16	15	28	97
Bacteria;Bacteria_none;Firmicutes;Clostridia;Clostridiales;Clostridiaceae;Clostridium sensu stricto 18	16	5	43	0	3	5	24	96
Bacteria;Bacteria_none;Bacteroidota;Bacteroidia;Flavobacteriales;Cryomorphaceae;Cryomorpha	69	0	0	0	8	0	14	91
Bacteria;Bacteria_none;Bacteroidota;Bacteroidia;Flavobacteriales;Flavobacteriaceae;Psychroserpens	15	0	0	3	10	39	22	89
Bacteria;Bacteria_none;Proteobacteria;Gammaproteobacteria;Pseudomonadales;Nitrincolaceae;Corallomonas	15	23	2	0	7	33	9	89
Bacteria;Bacteria_none;Firmicutes;Bacilli;Mycoplasmatales;Mycoplasmataceae;Mycoplasmataceae_uncultured	27	22	38	0	2	0	0	89
Bacteria;Bacteria_none;Proteobacteria;Gammaproteobacteria;Burkholderiales;Comamonadaceae;Macromonas	0	87	0	0	0	0	0	87
Bacteria;Bacteria_none;Firmicutes;Clostridia;Peptostreptococcales-Tissierellales;Peptostreptococcaceae;Intestinibacter	1	0	13	0	1	70	1	86
Bacteria;Bacteria_none;Firmicutes;Clostridia;Peptostreptococcales-Tissierellales;Peptostreptococcales-Tissierellales_Incertae_sedis;Clostridiisalibacter	84	0	0	0	0	0	0	84
Bacteria;Bacteria_none;Proteobacteria;Gammaproteobacteria;Pseudomonadales;Cellvibrionaceae;Cellvibrio	24	1	2	1	14	18	23	83
Bacteria;Bacteria_none;Proteobacteria;Alphaproteobacteria;Rhodobacterales;Rhodobacteraceae;Planktomarina	19	16	1	0	11	16	18	81
Bacteria;Bacteria_none;Actinobacteriota;Rubrobacteria;Rubrobacterales;Rubrobacteriaceae;Rubrobacter	73	0	0	0	0	0	0	73
Bacteria;Bacteria_none;Proteobacteria;Alphaproteobacteria;Rhodobacterales;Rhodobacteraceae;Yoonia-Loktanella	16	27	3	1	2	4	20	73
Bacteria;Bacteria_none;Firmicutes;Clostridia;Peptostreptococcales-Tissierellales;Peptostreptococcaceae;Peptostreptococcaceae_uncultured	15	0	21	0	2	32	3	73
Bacteria;Bacteria_none;Proteobacteria;Gammaproteobacteria;Enterobacterales;Enterobacteriaceae;Kluyvera	6	0	0	65	0	0	0	71
Bacteria;Bacteria_none;Proteobacteria;Gammaproteobacteria;Pseudomonadales;Porticoccaceae;SAR92 clade	16	1	1	1	6	11	35	71
Bacteria;Bacteria_none;Patescibacteria;Saccharimonadia;Saccharimonadales;Saccharimonadaceae;TM7a	0	1	0	0	1	53	13	68
Bacteria;Bacteria_none;Firmicutes;Bacilli;Bacillales;Planococcaceae;Lysinibacillus	1	0	0	67	0	0	0	68
Bacteria;Bacteria_none;Firmicutes;Clostridia;Clostridiales;Clostridiaceae;Clostridium sensu stricto 8	19	5	11	0	0	13	20	68
Bacteria;Bacteria_none;Planctomycetota;Phycisphaerae;Phycisphaerales;Phycisphaeraceae;Urania-1B-19 marine sediment group	0	66	0	0	1	0	0	67
Bacteria;Bacteria_none;Proteobacteria;Alphaproteobacteria;Rhodobacterales;Rhodobacteraceae;Thalassobius	15	0	0	0	0	41	11	67
Bacteria;Bacteria_none;Proteobacteria;Gammaproteobacteria;Thiotrichales;Thiotrichaceae;Leucothrix	44	0	0	0	3	19	0	66
Bacteria;Bacteria_none;Actinobacteriota;Actinobacteria;Propionibacteriales;Propionibacteriaceae;Raineyella	0	0	0	0	0	65	0	65
Bacteria;Bacteria_none;Planctomycetota;Planctomycetes;Pirellulales;Pirellulaceae;Bythopirellula	40	0	0	0	6	0	19	65
Bacteria;Bacteria_none;Bacteroidota;Bacteroidia;Flavobacteriales;Flavobacteriaceae;Algibacter	1	5	0	12	2	8	36	64
Bacteria;Bacteria_none;Planctomycetota;Planctomycetes;Pirellulales;Pirellulaceae;Pirellula	3	3	0	0	4	48	3	61
Bacteria;Bacteria_none;Firmicutes;Clostridia;Peptostreptococcales-Tissierellales;Family XI;Gallicola	60	0	0	0	0	0	1	61
Bacteria;Bacteria_none;Bacteroidota;Bacteroidia;Flavobacteriales;Flavobacteriaceae;Aquibacter	10	4	0	13	1	20	12	60
Bacteria;Bacteria_none;Proteobacteria;Gammaproteobacteria;Enterobacterales;Colwelliaceae;Thalassotalea	4	25	4	6	0	5	16	60
Bacteria;Bacteria_none;Actinobacteriota;Actinobacteria;Micrococcales;Intrasporangiaceae;Humibacillus	0	0	0	0	0	59	0	59
Bacteria;Bacteria_none;Proteobacteria;Gammaproteobacteria;Pseudomonadales;Oleiphilaceae;Oleiphilus	19	19	1	4	3	4	9	59
Bacteria;Bacteria_none;Bacteroidota;Bacteroidia;Flavobacteriales;Crocinitomicaceae;Crocinitomicaceae_uncultured	19	0	0	0	1	24	14	58
Bacteria;Bacteria_none;Firmicutes;Bacilli;Lactobacillales;Enterococcaceae;Enterococcus	20	0	1	0	0	0	34	55
Bacteria;Bacteria_none;Firmicutes;Clostridia;Clostridiales;Clostridiaceae;Haloimpatiens	0	0	1	0	0	39	15	55
Bacteria;Bacteria_none;Firmicutes;Clostridia;Peptostreptococcales-Tissierellales;Anaerovoracaceae;[Eubacterium] brachy group	0	0	0	0	0	0	54	54
Bacteria;Bacteria_none;Cyanobacteria;Cyanobacteriia;Cyanobacteriales;Microcystaceae;Chalicogloea CCALA 975	0	0	0	0	0	54	0	54
Bacteria;Bacteria_none;Firmicutes;Clostridia;Clostridiales;Clostridiaceae;Clostridium sensu stricto 12	14	8	7	0	6	3	16	54
Bacteria;Bacteria_none;Proteobacteria;Gammaproteobacteria;Legionellales;Legionellaceae;Legionella	5	1	7	3	18	1	18	53
Bacteria;Bacteria_none;Proteobacteria;Alphaproteobacteria;Rhodospirillales;Terasakiellaceae;Terasakiellaceae_uncultured	0	0	53	0	0	0	0	53
Bacteria;Bacteria_none;Proteobacteria;Gammaproteobacteria;Thiotrichales;Thiotrichaceae;Thiotrichaceae_uncultured	46	0	0	0	6	0	0	52
Bacteria;Bacteria_none;Proteobacteria;Gammaproteobacteria;Pseudomonadales;Porticoccaceae;Porticoccus	15	0	0	9	6	7	15	52
Bacteria;Bacteria_none;Proteobacteria;Gammaproteobacteria;Enterobacterales;Alteromonadaceae;Aestuariibacter	27	3	18	1	0	3	0	52
Bacteria;Bacteria_none;Actinobacteriota;Actinobacteria;Micrococcales;Intrasporangiaceae;Janibacter	0	0	0	0	0	49	2	51
Bacteria;Bacteria_none;Firmicutes;Clostridia;Oscillospirales;Ruminococcaceae;Ruminococcaceae_uncultured	0	50	0	1	0	0	0	51
Bacteria;Bacteria_none;Proteobacteria;Alphaproteobacteria;Rhodobacterales;Rhodobacteraceae;Celeribacter	41	1	2	0	1	6	0	51
Bacteria;Bacteria_none;Bacteroidota;Bacteroidia;Flavobacteriales;Flavobacteriaceae;Actibacter	0	44	0	0	0	1	4	49
Bacteria;Bacteria_none;Actinobacteriota;Acidimicrobiia;Microtrichales;Microtrichaceae;Microtrichaceae_uncultured	0	0	0	0	3	46	0	49
Bacteria;Bacteria_none;Firmicutes;Bacilli;Bacillales;Planococcaceae;Planococcaceae_uncultured	4	0	0	44	0	0	0	48
Bacteria;Bacteria_none;Proteobacteria;Alphaproteobacteria;Rhodobacterales;Rhodobacteraceae;Amylibacter	9	5	0	0	2	2	29	47
Bacteria;Bacteria_none;Proteobacteria;Alphaproteobacteria;Rhizobiales;Rhizobiaceae;Cohaesibacter	0	0	46	0	0	0	0	46
Bacteria;Bacteria_none;Actinobacteriota;Actinobacteria;Propionibacteriales;Propionibacteriaceae;Microlunatus	0	0	0	1	0	44	0	45
Bacteria;Bacteria_none;Firmicutes;Clostridia;Eubacteriales;Eubacteriaceae;Acetobacterium	0	0	0	0	11	0	34	45
Bacteria;Bacteria_none;Proteobacteria;Gammaproteobacteria;Enterobacterales;Enterobacteriaceae;Citrobacter	26	0	0	12	2	1	3	44
Bacteria;Bacteria_none;Proteobacteria;Alphaproteobacteria;Rhodobacterales;Rhodobacteraceae;Roseivivax	15	10	0	0	0	14	5	44
Bacteria;Bacteria_none;Desulfobacterota;Desulfobulbia;Desulfobulbales;Desulfocapsaceae;Desulfocapsa	1	2	34	0	0	6	1	44
Bacteria;Bacteria_none;Proteobacteria;Alphaproteobacteria;Rhodobacterales;Rhodobacteraceae;Pseudophaeobacter	5	17	0	0	0	13	8	43
Bacteria;Bacteria_none;Bacteroidota;Bacteroidia;Flavobacteriales;Flavobacteriaceae;Maribacter	3	0	0	5	0	4	29	41
Bacteria;Bacteria_none;Proteobacteria;Gammaproteobacteria;Pseudomonadales;Nitrincolaceae;Neptuniibacter	7	1	2	6	2	4	18	40
Bacteria;Bacteria_none;Proteobacteria;Gammaproteobacteria;Nitrosococcales;Nitrosococcaceae;Cm1-21	0	0	0	0	0	39	0	39
Bacteria;Bacteria_none;Proteobacteria;Alphaproteobacteria;Tistrellales;Geminicoccaceae;Geminicoccaceae_uncultured	0	27	0	0	0	0	12	39
Bacteria;Bacteria_none;Firmicutes;Bacilli;Erysipelotrichales;Erysipelotrichaceae;Solobacterium	0	39	0	0	0	0	0	39
Bacteria;Bacteria_none;Bacteroidota;Bacteroidia;Flavobacteriales;Flavobacteriaceae;Capnocytophaga	4	1	0	10	5	11	8	39
Bacteria;Bacteria_none;Proteobacteria;Alphaproteobacteria;Rhodobacterales;Rhodobacteraceae;Rhodobacter	13	5	0	0	0	13	7	38
Bacteria;Bacteria_none;Proteobacteria;Gammaproteobacteria;Burkholderiales;Rhodocyclaceae;Sulfuritalea	35	0	0	2	0	0	0	37
Bacteria;Bacteria_none;Bacteroidota;Bacteroidia;Flavobacteriales;Crocinitomicaceae;Brumimicrobium	0	0	0	0	0	0	37	37
Bacteria;Bacteria_none;Proteobacteria;Gammaproteobacteria;Enterobacterales;Aeromonadaceae;Oceanisphaera	4	0	1	6	0	0	25	36
Bacteria;Bacteria_none;Proteobacteria;Gammaproteobacteria;Enterobacterales;Kangiellaceae;Kangiellaceae_uncultured	16	0	5	0	10	0	4	35
Bacteria;Bacteria_none;Proteobacteria;Gammaproteobacteria;Pseudomonadales;Cellvibrionaceae;Maricurvus	4	9	6	0	6	0	10	35
Bacteria;Bacteria_none;Desulfobacterota;Desulfobulbia;Desulfobulbales;Desulfocapsaceae;Desulfotalea	1	34	0	0	0	0	0	35
Bacteria;Bacteria_none;Firmicutes;Clostridia;Clostridiales;Clostridiaceae;Clostridium sensu stricto 11	5	1	11	0	0	1	16	34
Bacteria;Bacteria_none;Bacteroidota;Bacteroidia;Chitinophagales;Saprospiraceae;Saprospiraceae_uncultured	0	0	0	0	1	33	0	34
Bacteria;Bacteria_none;Bacteroidota;Bacteroidia;Flavobacteriales;Flavobacteriaceae;Marixanthomonas	14	5	0	0	2	0	12	33
Bacteria;Bacteria_none;Bacteroidota;Bacteroidia;Flavobacteriales;Flavobacteriaceae;Aequorivita	10	0	0	4	0	1	18	33
Bacteria;Bacteria_none;Proteobacteria;Gammaproteobacteria;Burkholderiales;Neisseriaceae;Neisseria	6	0	0	1	8	0	18	33
Bacteria;Bacteria_none;Proteobacteria;Alphaproteobacteria;Rhizobiales;Devosiaceae;Devosiaceae_uncultured	1	4	0	0	0	0	26	31
Bacteria;Bacteria_none;Proteobacteria;Alphaproteobacteria;Rhodobacterales;Rhodobacteraceae;Pseudoruegeria	1	6	0	0	7	9	8	31
Bacteria;Bacteria_none;Bacteroidota;Bacteroidia;Flavobacteriales;Flavobacteriaceae;Olleya	6	2	0	10	0	10	3	31
Bacteria;Bacteria_none;Patescibacteria;Saccharimonadia;Saccharimonadales;Saccharimonadaceae;Candidatus Saccharimonas	0	20	0	0	6	3	1	30
Bacteria;Bacteria_none;Proteobacteria;Gammaproteobacteria;Chromatiales;Sedimenticolaceae;Sedimenticolaceae_uncultured	0	6	0	1	12	2	9	30
Bacteria;Bacteria_none;Proteobacteria;Gammaproteobacteria;Enterobacterales;Erwiniaceae;Pantoea	8	0	0	22	0	0	0	30
Bacteria;Bacteria_none;Firmicutes;Bacilli;Lactobacillales;Carnobacteriaceae;Lacticigenium	0	0	0	0	0	30	0	30
Bacteria;Bacteria_none;Proteobacteria;Gammaproteobacteria;Burkholderiales;Nitrosomonadaceae;Nitrosomonas	0	7	0	1	0	0	22	30
Bacteria;Bacteria_none;Bacteroidota;Bacteroidia;Flavobacteriales;Flavobacteriaceae;Maritimimonas	2	0	1	5	7	3	11	29
Bacteria;Bacteria_none;Proteobacteria;Alphaproteobacteria;Rhodobacterales;Rhodobacteraceae;Loktanella	0	0	0	0	3	0	25	28
Bacteria;Bacteria_none;Bacteroidota;Bacteroidia;Flavobacteriales;Flavobacteriaceae;Xanthomarina	3	0	0	14	1	6	4	28
Bacteria;Bacteria_none;Actinobacteriota;Actinobacteria;Micrococcales;Microbacteriaceae;Agrococcus	0	0	0	0	0	28	0	28
Bacteria;Bacteria_none;Firmicutes;Clostridia;Monoglobales;Monoglobaceae;Monoglobus	1	0	26	0	0	0	0	27
Bacteria;Bacteria_none;Proteobacteria;Gammaproteobacteria;Pseudomonadales;Halomonadaceae;Halomonadaceae_uncultured	2	0	1	1	10	6	7	27
Bacteria;Bacteria_none;Proteobacteria;Gammaproteobacteria;Pseudomonadales;Nitrincolaceae;Amphritea	7	0	0	7	0	2	11	27
Bacteria;Bacteria_none;Proteobacteria;Gammaproteobacteria;Enterobacterales;Pseudoalteromonadaceae;Algicola	12	0	0	12	0	0	3	27
Bacteria;Bacteria_none;Bacteroidota;Bacteroidia;Bacteroidales;Tannerellaceae;Parabacteroides	4	0	0	0	0	0	22	26
Bacteria;Bacteria_none;Proteobacteria;Alphaproteobacteria;Rhodobacterales;Rhodobacteraceae;Tateyamaria	2	12	0	0	0	5	7	26
Bacteria;Bacteria_none;Desulfobacterota;Desulfobacteria;Desulfatiglandales;Desulfatiglandaceae;Desulfatiglans	0	0	0	0	0	0	26	26
Bacteria;Bacteria_none;Firmicutes;Clostridia;Clostridiales;Clostridiaceae;Clostridium sensu stricto 6	7	3	4	0	3	0	8	25
Bacteria;Bacteria_none;Actinobacteriota;Actinobacteria;Propionibacteriales;Propionibacteriaceae;Propionibacteriaceae_uncultured	4	0	0	0	5	14	2	25
Bacteria;Bacteria_none;Proteobacteria;Alphaproteobacteria;Kiloniellales;Kiloniellaceae;Pelagibius	0	25	0	0	0	0	0	25
Bacteria;Bacteria_none;Firmicutes;Clostridia;Clostridiales;Clostridiaceae;Clostridium sensu stricto 5	7	1	3	0	2	1	11	25
Bacteria;Bacteria_none;Bacteroidota;Bacteroidia;Flavobacteriales;Flavobacteriaceae;Salinimicrobium	4	2	1	3	1	11	3	25
Bacteria;Bacteria_none;Proteobacteria;Alphaproteobacteria;Rhodobacterales;Rhodobacteraceae;Roseibacterium	20	3	0	0	0	2	0	25
Bacteria;Bacteria_none;Proteobacteria;Alphaproteobacteria;Rhodobacterales;Rhodobacteraceae;Cognatishimia	0	24	0	0	0	0	0	24
Bacteria;Bacteria_none;Bacteroidota;Bacteroidia;Flavobacteriales;Cryomorphaceae;NS10 marine group	0	0	24	0	0	0	0	24
Bacteria;Bacteria_none;Firmicutes;Clostridia;Peptostreptococcales-Tissierellales;Family XI;Parvimonas	0	0	0	0	2	15	7	24
Bacteria;Bacteria_none;Actinobacteriota;Actinobacteria;Micrococcales;Microbacteriaceae;Leucobacter	0	0	0	0	0	23	1	24
Bacteria;Bacteria_none;Firmicutes;Clostridia;Peptococcales;Peptococcaceae;Peptococcaceae_uncultured	0	0	22	0	0	1	0	23
Bacteria;Bacteria_none;Firmicutes;Clostridia;Lachnospirales;Lachnospiraceae;Lachnospiraceae UCG-008	8	0	0	0	0	15	0	23
Bacteria;Bacteria_none;Proteobacteria;Gammaproteobacteria;Pseudomonadales;Halomonadaceae;Aidingimonas	5	0	0	0	5	0	12	22
Bacteria;Bacteria_none;Firmicutes;Clostridia;Oscillospirales;Ruminococcaceae;Fournierella	0	0	0	0	0	0	22	22
Bacteria;Bacteria_none;Firmicutes;Clostridia;Peptococcales;Peptococcaceae;Desulfonispora	0	0	0	0	2	20	0	22
Bacteria;Bacteria_none;Proteobacteria;Alphaproteobacteria;Rhodobacterales;Rhodobacteraceae;Roseobacter	12	4	0	0	1	1	4	22
Bacteria;Bacteria_none;Firmicutes;Bacilli;Bacillales;Planococcaceae;Psychrobacillus	0	0	0	22	0	0	0	22
Bacteria;Bacteria_none;Proteobacteria;Alphaproteobacteria;Rhodobacterales;Rhodobacteraceae;Ponticoccus	0	0	0	0	0	22	0	22
Bacteria;Bacteria_none;Myxococcota;Polyangia;Polyangiales;Sandaracinaceae;Sandaracinaceae_uncultured	0	0	0	0	14	0	8	22
Bacteria;Bacteria_none;Proteobacteria;Gammaproteobacteria;Enterobacterales;Enterobacteriaceae;Plesiomonas	14	0	1	7	0	0	0	22
Bacteria;Bacteria_none;Proteobacteria;Alphaproteobacteria;Rhizobiales;Rhizobiaceae;Ahrensia	0	0	0	0	0	0	22	22
Bacteria;Bacteria_none;Proteobacteria;Gammaproteobacteria;Enterobacterales;Morganellaceae;Morganella	14	0	0	6	0	0	1	21
Bacteria;Bacteria_none;Firmicutes;Clostridia;Lachnospirales;Lachnospiraceae;Agathobacter	12	0	0	0	0	9	0	21
Bacteria;Bacteria_none;Proteobacteria;Alphaproteobacteria;Rhodobacterales;Rhodobacteraceae;Defluviimonas	8	3	0	0	8	0	2	21
Bacteria;Bacteria_none;Firmicutes;Clostridia;Oscillospirales;Oscillospiraceae;Oscillibacter	2	0	0	0	0	0	18	20
Bacteria;Bacteria_none;Firmicutes;Clostridia;Peptostreptococcales-Tissierellales;Dethiosulfatibacteraceae;Dethiosulfatibacter	0	0	0	0	5	0	15	20
Bacteria;Bacteria_none;Bacteroidota;Bacteroidia;Flavobacteriales;Flavobacteriaceae;NS4 marine group	3	1	0	9	0	2	5	20
Bacteria;Bacteria_none;Proteobacteria;Alphaproteobacteria;Rhizobiales;Methyloligellaceae;Methyloligellaceae_uncultured	0	2	0	0	7	2	9	20
Bacteria;Bacteria_none;Proteobacteria;Alphaproteobacteria;Sphingomonadales;Sphingomonadaceae;Sphingomonas	0	0	0	4	0	0	16	20
Bacteria;Bacteria_none;Proteobacteria;Gammaproteobacteria;Nitrosococcales;Nitrosococcaceae;AqS1	1	0	0	0	0	0	19	20
Bacteria;Bacteria_none;Bacteroidota;Bacteroidia;Flavobacteriales;Flavobacteriaceae;Lutibacter	1	1	0	0	4	2	12	20
Bacteria;Bacteria_none;Proteobacteria;Gammaproteobacteria;Pseudomonadales;Saccharospirillaceae;Saccharospirillaceae_uncultured	5	2	0	1	0	2	9	19
Bacteria;Bacteria_none;Firmicutes;Clostridia;Peptostreptococcales-Tissierellales;Anaerovoracaceae;[Eubacterium] nodatum group	4	0	1	0	4	4	6	19
Bacteria;Bacteria_none;Proteobacteria;Alphaproteobacteria;SAR11 clade;Clade I;Clade Ib	19	0	0	0	0	0	0	19
Bacteria;Bacteria_none;Actinobacteriota;Actinobacteria;Corynebacteriales;Corynebacteriaceae;Corynebacterium	0	0	0	1	0	17	1	19
Bacteria;Bacteria_none;Proteobacteria;Gammaproteobacteria;Enterobacterales;Psychromonadaceae;Agarivorans	10	0	0	9	0	0	0	19
Bacteria;Bacteria_none;Proteobacteria;Alphaproteobacteria;Rhodobacterales;Rhodobacteraceae;Epibacterium	0	7	0	0	0	6	5	18
Bacteria;Bacteria_none;Bacteroidota;Bacteroidia;Chitinophagales;Chitinophagaceae;Sediminibacterium	18	0	0	0	0	0	0	18
Bacteria;Bacteria_none;Actinobacteriota;Actinobacteria;Propionibacteriales;Propionibacteriaceae;Luteococcus	0	0	0	0	0	18	0	18
Bacteria;Bacteria_none;Firmicutes;Clostridia;Peptostreptococcales-Tissierellales;Anaerovoracaceae;Family XIII AD3011 group	0	0	0	0	0	7	11	18
Bacteria;Bacteria_none;Firmicutes;Clostridia;Peptostreptococcales-Tissierellales;Anaerovoracaceae;Anaerovorax	0	0	0	0	0	0	18	18
Bacteria;Bacteria_none;Proteobacteria;Gammaproteobacteria;Enterobacterales;Kangiellaceae;Pleionea	4	2	3	0	2	2	5	18
Bacteria;Bacteria_none;Planctomycetota;Planctomycetes;Planctomycetales;Rubinisphaeraceae;Planctomicrobium	0	0	0	0	17	0	1	18
Bacteria;Bacteria_none;Proteobacteria;Alphaproteobacteria;Rhodobacterales;Rhodobacteraceae;Oceaniovalibus	1	0	0	0	1	0	16	18
Bacteria;Bacteria_none;Proteobacteria;Alphaproteobacteria;Rhodobacterales;Rhodobacteraceae;Shimia	4	2	0	0	0	3	9	18
Bacteria;Bacteria_none;Proteobacteria;Alphaproteobacteria;Rhodobacterales;Rhodobacteraceae;Marinibacterium	17	0	0	0	0	0	1	18
Bacteria;Bacteria_none;Proteobacteria;Alphaproteobacteria;Rhodobacterales;Rhodobacteraceae;Roseobacter clade CHAB-I-5 lineage	2	15	0	0	0	0	0	17
Bacteria;Bacteria_none;Bacteroidota;Bacteroidia;Flavobacteriales;Flavobacteriaceae;Muricauda	1	0	1	6	3	1	5	17
Bacteria;Bacteria_none;Proteobacteria;Gammaproteobacteria;Pseudomonadales;Halomonadaceae;Salinicola	2	0	0	1	2	1	11	17
Bacteria;Bacteria_none;Actinobacteriota;Actinobacteria;Corynebacteriales;Mycobacteriaceae;Mycobacterium	0	0	0	1	10	0	5	16
Bacteria;Bacteria_none;Bacteroidota;Bacteroidia;Flavobacteriales;Flavobacteriaceae;NS3a marine group	2	1	0	3	2	4	4	16
Bacteria;Bacteria_none;Firmicutes;Clostridia;Peptostreptococcales-Tissierellales;Peptostreptococcales-Tissierellales_Incertae_sedis;uncultured	0	0	0	0	0	0	16	16
Bacteria;Bacteria_none;Proteobacteria;Alphaproteobacteria;Rhodobacterales;Rhodobacteraceae;Pseudorhodobacter	2	3	1	1	2	2	5	16
Bacteria;Bacteria_none;Firmicutes;Clostridia;Clostridiales;Clostridiaceae;Proteiniclasticum	6	0	4	0	0	3	3	16
Bacteria;Bacteria_none;Proteobacteria;Gammaproteobacteria;Arenicellales;Arenicellaceae;Arenicellaceae_uncultured	10	0	0	4	0	0	2	16
Bacteria;Bacteria_none;Firmicutes;Clostridia;Clostridiales;Clostridiaceae;Clostridium sensu stricto 4	0	0	0	0	15	1	0	16
Bacteria;Bacteria_none;Desulfobacterota;Desulfobulbia;Desulfobulbales;Desulfocapsaceae;[Desulfobacterium] catecholicum group	1	2	2	0	0	1	9	15
Bacteria;Bacteria_none;Proteobacteria;Gammaproteobacteria;Enterobacterales;Idiomarinaceae;Idiomarina	7	1	1	5	1	0	0	15
Bacteria;Bacteria_none;Desulfobacterota;Desulfobacteria;Desulfobacterales;Desulfosarcinaceae;SEEP-SRB1	0	0	0	0	0	0	15	15
Bacteria;Bacteria_none;Proteobacteria;Alphaproteobacteria;Rhodobacterales;Rhodobacteraceae;Donghicola	2	1	1	0	0	3	8	15
Bacteria;Bacteria_none;Proteobacteria;Gammaproteobacteria;Pseudomonadales;Halomonadaceae;Chromohalobacter	10	1	0	0	0	1	3	15
Bacteria;Bacteria_none;Proteobacteria;Alphaproteobacteria;Rhodobacterales;Rhodobacteraceae;Aliiroseovarius	3	2	2	0	1	2	5	15
Bacteria;Bacteria_none;Bacteroidota;Bacteroidia;Flavobacteriales;Flavobacteriaceae;Kordia	4	0	0	4	0	3	4	15
Bacteria;Bacteria_none;Actinobacteriota;Coriobacteriia;Coriobacteriales;Coriobacteriales Incertae Sedis;Raoultibacter	2	0	0	0	5	0	8	15
Bacteria;Bacteria_none;Proteobacteria;Alphaproteobacteria;SAR11 clade;Clade I;Clade I_uncultured	10	0	0	0	4	0	1	15
Bacteria;Bacteria_none;Firmicutes;Clostridia;Peptostreptococcales-Tissierellales;Peptostreptococcaceae;Tepidibacter	3	0	9	0	1	1	0	14
Bacteria;Bacteria_none;Proteobacteria;Alphaproteobacteria;Rhodobacterales;Rhodobacteraceae;Nioella	4	4	2	0	1	1	2	14
Bacteria;Bacteria_none;Bdellovibrionota;Bdellovibrionia;Bacteriovoracales;Bacteriovoracaceae;Halobacteriovorax	0	0	0	0	0	0	14	14
Bacteria;Bacteria_none;Proteobacteria;Gammaproteobacteria;Enterobacterales;Yersiniaceae;Yersinia	0	0	0	13	0	0	1	14
Bacteria;Bacteria_none;Actinobacteriota;Actinobacteria;Actinomycetales;Actinomycetaceae;Actinomyces	13	0	0	1	0	0	0	14
Bacteria;Bacteria_none;Proteobacteria;Gammaproteobacteria;Enterobacterales;Enterobacteriaceae;Kosakonia	4	0	0	8	0	1	1	14
Bacteria;Bacteria_none;Proteobacteria;Gammaproteobacteria;Enterobacterales;Vibrionaceae;Aliivibrio	11	0	0	2	0	0	1	14
Bacteria;Bacteria_none;Bacteroidota;Bacteroidia;Flavobacteriales;Flavobacteriaceae;Nonlabens	0	0	0	0	0	7	7	14
Bacteria;Bacteria_none;Proteobacteria;Gammaproteobacteria;Enterobacterales;Alteromonadaceae;Rheinheimera	7	0	0	4	0	0	3	14
Bacteria;Bacteria_none;Firmicutes;Clostridia;Oscillospirales;Ruminococcaceae;Paludicola	0	0	0	0	0	0	14	14
Bacteria;Bacteria_none;Bacteroidota;Bacteroidia;Flavobacteriales;Flavobacteriaceae;Aquimarina	1	0	0	3	1	5	3	13
Bacteria;Bacteria_none;Proteobacteria;Alphaproteobacteria;Rhodobacterales;Rhodobacteraceae;Octadecabacter	4	1	0	0	1	0	7	13
Bacteria;Bacteria_none;Firmicutes;Clostridia;Peptostreptococcales-Tissierellales;Family XI;W5053	0	13	0	0	0	0	0	13
Bacteria;Bacteria_none;Firmicutes;Bacilli;Lactobacillales;Carnobacteriaceae;Trichococcus	0	0	0	0	0	2	11	13
Bacteria;Bacteria_none;Proteobacteria;Alphaproteobacteria;Rhodobacterales;Rhodobacteraceae;Maritimibacter	1	0	0	0	0	8	4	13
Bacteria;Bacteria_none;Proteobacteria;Gammaproteobacteria;Thiotrichales;Thiotrichaceae;Thiothrix	7	3	2	1	0	0	0	13
Bacteria;Bacteria_none;Actinobacteriota;Actinobacteria;Propionibacteriales;Nocardioidaceae;Nocardioides	0	0	0	0	1	12	0	13
Bacteria;Bacteria_none;Proteobacteria;Alphaproteobacteria;Rhodobacterales;Rhodobacteraceae;Pelagicola	10	1	0	0	1	1	0	13
Bacteria;Bacteria_none;Firmicutes;Bacilli;Bacillales;Planococcaceae;Chryseomicrobium	0	0	0	13	0	0	0	13
Bacteria;Bacteria_none;Firmicutes;Bacilli;Bacillales;Planococcaceae;Bhargavaea	2	0	0	11	0	0	0	13
Bacteria;Bacteria_none;Proteobacteria;Gammaproteobacteria;Pseudomonadales;Cellvibrionaceae;Gilvimarinus	5	0	2	0	0	2	4	13
Bacteria;Bacteria_none;Bacteroidota;Bacteroidia;Flavobacteriales;Flavobacteriaceae;Dokdonia	2	0	0	4	0	4	2	12
Bacteria;Bacteria_none;Proteobacteria;Gammaproteobacteria;Enterobacterales;Enterobacteriaceae;Cronobacter	2	0	0	2	2	0	6	12
Bacteria;Bacteria_none;Patescibacteria;Saccharimonadia;Saccharimonadales;Saccharimonadaceae;TM7x	0	0	0	0	0	12	0	12
Bacteria;Bacteria_none;Bacteroidota;Bacteroidia;Flavobacteriales;Flavobacteriaceae;NS2b marine group	1	3	0	4	0	1	3	12
Bacteria;Bacteria_none;Actinobacteriota;Actinobacteria;Micrococcales;Intrasporangiaceae;Tetrasphaera	0	0	0	0	0	5	7	12
Bacteria;Bacteria_none;Proteobacteria;Gammaproteobacteria;Gammaproteobacteria Incertae Sedis;Unknown Family;Candidatus Berkiella	0	0	0	0	12	0	0	12
Bacteria;Bacteria_none;Bacteroidota;Bacteroidia;Flavobacteriales;Flavobacteriaceae;Robiginitalea	1	3	0	2	0	2	4	12
Bacteria;Bacteria_none;Proteobacteria;Gammaproteobacteria;Methylococcales;Methylomonadaceae;IheB2-23	1	1	10	0	0	0	0	12
Bacteria;Bacteria_none;Firmicutes;Bacilli;Mycoplasmatales;Mycoplasmataceae;Candidatus Bacilloplasma	0	6	0	0	0	0	6	12
Bacteria;Bacteria_none;Proteobacteria;Alphaproteobacteria;Rhodobacterales;Rhodobacteraceae;Leisingera	3	1	0	0	0	1	6	11
Bacteria;Bacteria_none;Proteobacteria;Gammaproteobacteria;Pseudomonadales;Saccharospirillaceae;Thalassolituus	0	0	0	0	0	0	11	11
Bacteria;Bacteria_none;Firmicutes;Clostridia;Clostridiales;Clostridiaceae;Clostridium sensu stricto 3	5	1	2	0	0	0	3	11
Bacteria;Bacteria_none;Firmicutes;Clostridia;Oscillospirales;Oscillospiraceae;Colidextribacter	0	0	0	0	0	11	0	11
Bacteria;Bacteria_none;Firmicutes;Clostridia;Christensenellales;Christensenellaceae;Christensenellaceae_uncultured	0	0	0	0	11	0	0	11
Bacteria;Bacteria_none;Proteobacteria;Gammaproteobacteria;Pseudomonadales;Pseudomonadaceae;Azotobacter	6	0	0	0	0	0	5	11
Bacteria;Bacteria_none;Actinobacteriota;Actinobacteria;Corynebacteriales;Dietziaceae;Dietzia	11	0	0	0	0	0	0	11
Bacteria;Bacteria_none;Firmicutes;Bacilli;Erysipelotrichales;Erysipelotrichaceae;Erysipelotrichaceae_uncultured	1	8	0	0	0	0	1	10
Bacteria;Bacteria_none;Proteobacteria;Gammaproteobacteria;Enterobacterales;Pectobacteriaceae;Pectobacterium	3	0	0	4	0	3	0	10
Bacteria;Bacteria_none;Campylobacterota;Campylobacteria;Campylobacterales;Sulfurimonadaceae;Sulfurimonas	0	0	0	0	7	1	2	10
Bacteria;Bacteria_none;Proteobacteria;Gammaproteobacteria;Enterobacterales;Pasteurellaceae;Actinobacillus	2	0	0	2	0	6	0	10
Bacteria;Bacteria_none;Proteobacteria;Gammaproteobacteria;Burkholderiales;Oxalobacteraceae;Candidatus Zinderia	8	0	0	0	1	0	1	10
Bacteria;Bacteria_none;Firmicutes;Clostridia;Lachnospirales;Lachnospiraceae;Blautia	3	0	0	0	0	4	3	10
Bacteria;Bacteria_none;Proteobacteria;Gammaproteobacteria;Enterobacterales;Morganellaceae;Proteus	7	0	0	3	0	0	0	10
Bacteria;Bacteria_none;Proteobacteria;Gammaproteobacteria;Methylococcales;Methylomonadaceae;Marine Methylotrophic Group 2	1	0	0	0	0	3	6	10
Bacteria;Bacteria_none;Proteobacteria;Alphaproteobacteria;Rhodobacterales;Rhodobacteraceae;Tropicibacter	6	1	1	0	0	0	2	10
Bacteria;Bacteria_none;Proteobacteria;Alphaproteobacteria;Rhodobacterales;Rhodobacteraceae;Pelagimonas	0	0	0	0	0	0	10	10
Bacteria;Bacteria_none;Proteobacteria;Alphaproteobacteria;Rhodobacterales;Rhodobacteraceae;HIMB11	5	1	0	0	0	1	2	9
Bacteria;Bacteria_none;Proteobacteria;Gammaproteobacteria;Burkholderiales;Burkholderiaceae;Burkholderia-Caballeronia-Paraburkholderia	5	0	0	2	0	0	2	9
Bacteria;Bacteria_none;Proteobacteria;Gammaproteobacteria;Pseudomonadales;Spongiibacteraceae;Sinobacterium	5	0	0	0	0	0	4	9
Bacteria;Bacteria_none;Proteobacteria;Gammaproteobacteria;Enterobacterales;Vibrionaceae;Salinivibrio	4	1	0	3	0	0	1	9
Bacteria;Bacteria_none;Proteobacteria;Gammaproteobacteria;Ectothiorhodospirales;Ectothiorhodospiraceae;Thioalkalivibrio	3	0	1	4	0	0	1	9
Bacteria;Bacteria_none;Proteobacteria;Gammaproteobacteria;Burkholderiales;Alcaligenaceae;Achromobacter	5	1	0	2	0	0	1	9
Bacteria;Bacteria_none;Actinobacteriota;Actinobacteria;Corynebacteriales;Nocardiaceae;Rhodococcus	0	0	0	0	8	0	1	9
Bacteria;Bacteria_none;Proteobacteria;Gammaproteobacteria;Burkholderiales;Burkholderiaceae;Limnobacter	2	0	0	0	0	0	7	9
Bacteria;Bacteria_none;Proteobacteria;Alphaproteobacteria;Rhodobacterales;Rhodobacteraceae;Frigidibacter	4	0	0	0	0	0	5	9
Bacteria;Bacteria_none;Firmicutes;Bacilli;Alicyclobacillales;Alicyclobacillaceae;Tumebacillus	1	0	0	8	0	0	0	9
Bacteria;Bacteria_none;Proteobacteria;Alphaproteobacteria;Rhizobiales;Rhizobiaceae;Mesorhizobium	0	0	0	0	9	0	0	9
Bacteria;Bacteria_none;Firmicutes;Bacilli;Lactobacillales;Catellicoccaceae;Catellicoccus	0	0	0	0	9	0	0	9
Bacteria;Bacteria_none;Proteobacteria;Alphaproteobacteria;Rhodobacterales;Rhodobacteraceae;Mameliella	1	2	0	0	1	1	3	8
Bacteria;Bacteria_none;Bacteroidota;Bacteroidia;Flavobacteriales;Flavobacteriaceae;Gillisia	3	1	0	2	0	2	0	8
Bacteria;Bacteria_none;Firmicutes;Clostridia;Clostridiales;Clostridiaceae;Clostridium sensu stricto 9	2	1	0	0	1	0	4	8
Bacteria;Bacteria_none;Firmicutes;Clostridia;Clostridiales;Clostridiaceae;Clostridium sensu stricto 16	1	3	1	0	0	0	3	8
Bacteria;Bacteria_none;Bacteroidota;Bacteroidia;Flavobacteriales;Flavobacteriaceae;Cellulophaga	4	0	0	1	0	2	1	8
Bacteria;Bacteria_none;Firmicutes;Clostridia;Clostridiales;Clostridiaceae;Clostridium sensu stricto 17	1	0	0	0	6	1	0	8
Bacteria;Bacteria_none;Proteobacteria;Gammaproteobacteria;Burkholderiales;Procabacteriaceae;Procabacter	6	0	0	1	0	0	1	8
Bacteria;Bacteria_none;Firmicutes;Clostridia;Clostridiales;Clostridiaceae;Candidatus Arthromitus	2	2	1	0	0	0	3	8
Bacteria;Bacteria_none;Bacteroidota;Bacteroidia;Flavobacteriales;Flavobacteriaceae;Gramella	6	0	0	1	0	1	0	8
Bacteria;Bacteria_none;Firmicutes;Bacilli;Erysipelotrichales;Erysipelotrichaceae;[Anaerorhabdus] furcosa group	7	0	0	0	1	0	0	8
Bacteria;Bacteria_none;Proteobacteria;Gammaproteobacteria;Pseudomonadales;Moraxellaceae;Alkanindiges	2	0	0	0	3	2	1	8
Bacteria;Bacteria_none;Proteobacteria;Alphaproteobacteria;Rhodobacterales;Rhodobacteraceae;Pseudodonghicola	8	0	0	0	0	0	0	8
Bacteria;Bacteria_none;Proteobacteria;Gammaproteobacteria;Pseudomonadales;Moraxellaceae;Moraxellaceae_uncultured	1	0	1	0	0	1	5	8
Eukaryota;Chloroplastida;Phragmoplastophyta;Embryophyta;Malpighiales;Malpighiales_Incertae_sedis;Hevea	3	1	1	0	1	1	1	8
Bacteria;Bacteria_none;Firmicutes;Clostridia;Lachnospirales;Lachnospiraceae;Pseudobutyrivibrio	0	0	0	0	0	0	8	8
Bacteria;Bacteria_none;Proteobacteria;Gammaproteobacteria;Enterobacterales;Succinivibrionaceae;Succinivibrio	4	0	0	2	0	0	2	8
Bacteria;Bacteria_none;Proteobacteria;Gammaproteobacteria;Burkholderiales;Sulfuricellaceae;Sulfuricella	2	0	0	5	0	0	0	7
Bacteria;Bacteria_none;Proteobacteria;Alphaproteobacteria;Kiloniellales;Kiloniellaceae;Kiloniellaceae_uncultured	0	0	0	0	7	0	0	7
Bacteria;Bacteria_none;Desulfobacterota;Desulfuromonadia;Bradymonadales;Bradymonadaceae;Bradymonas	0	0	0	0	0	0	7	7
Bacteria;Bacteria_none;Firmicutes;Clostridia;Lachnospirales;Lachnospiraceae;Lachnospiraceae AC2044 group	0	0	0	0	7	0	0	7
Bacteria;Bacteria_none;Firmicutes;Clostridia;Clostridiales;Clostridiaceae;Clostridium sensu stricto 2	2	0	2	0	1	1	1	7
Bacteria;Bacteria_none;Proteobacteria;Gammaproteobacteria;Pseudomonadales;Cellvibrionaceae;Marinimicrobium	3	0	1	0	0	2	1	7
Bacteria;Bacteria_none;Proteobacteria;Gammaproteobacteria;Enterobacterales;Alteromonadaceae;Alteromonadaceae_uncultured	0	0	0	1	0	0	6	7
Bacteria;Bacteria_none;Proteobacteria;Alphaproteobacteria;Rhodobacterales;Rhodobacteraceae;Silicimonas	4	0	0	0	0	1	2	7
Bacteria;Bacteria_none;Firmicutes;Clostridia;Clostridiales;Clostridiaceae;Clostridiaceae_uncultured	4	0	2	0	0	0	1	7
Bacteria;Bacteria_none;Proteobacteria;Gammaproteobacteria;Enterobacterales;Pasteurellaceae;Pasteurellaceae_uncultured	1	0	0	0	0	6	0	7
Bacteria;Bacteria_none;Proteobacteria;Gammaproteobacteria;Enterobacterales;Alteromonadaceae;Paraglaciecola	2	0	0	5	0	0	0	7
Bacteria;Bacteria_none;Firmicutes;Clostridia;Lachnospirales;Lachnospiraceae;Lachnoclostridium	1	0	0	0	1	3	2	7
Bacteria;Bacteria_none;Planctomycetota;Planctomycetes;Pirellulales;Pirellulaceae;Termite planctomycete cluster	0	0	0	0	0	0	7	7
Bacteria;Bacteria_none;Proteobacteria;Gammaproteobacteria;Pseudomonadales;Spongiibacteraceae;Litorivivens	5	0	0	0	2	0	0	7
Bacteria;Bacteria_none;Proteobacteria;Gammaproteobacteria;Burkholderiales;Methylophilaceae;OM43 clade	0	0	0	0	0	7	0	7
Bacteria;Bacteria_none;Actinobacteriota;Actinobacteria;Kineosporiales;Kineosporiaceae;Quadrisphaera	0	0	0	0	0	6	0	6
Bacteria;Bacteria_none;Bacteroidota;Bacteroidia;Flavobacteriales;Flavobacteriaceae;Subsaximicrobium	2	1	0	1	1	1	0	6
Bacteria;Bacteria_none;Proteobacteria;Alphaproteobacteria;Rhodobacterales;Rhodobacteraceae;Pseudooceanicola	1	0	0	0	2	1	2	6
Bacteria;Bacteria_none;Bacteroidota;Bacteroidia;Flavobacteriales;Flavobacteriaceae;Zobellia	1	0	0	1	0	2	2	6
Bacteria;Bacteria_none;Firmicutes;Clostridia;Clostridiales;Clostridiaceae;Clostridium sensu stricto 15	0	0	1	0	0	1	4	6
Bacteria;Bacteria_none;Firmicutes;Clostridia;Peptostreptococcales-Tissierellales;Peptostreptococcaceae;Peptostreptococcus	0	0	0	0	0	6	0	6
Bacteria;Bacteria_none;Proteobacteria;Alphaproteobacteria;Rhodobacterales;Rhodobacteraceae;Rubellimicrobium	2	1	0	0	0	0	3	6
Bacteria;Bacteria_none;Firmicutes;Clostridia;Lachnospirales;Lachnospiraceae;Natranaerovirga	0	0	0	0	0	0	6	6
Bacteria;Bacteria_none;Proteobacteria;Gammaproteobacteria;Enterobacterales;Idiomarinaceae;Aliidiomarina	6	0	0	0	0	0	0	6
Bacteria;Bacteria_none;Firmicutes;Clostridia;Clostridiales;Clostridiaceae;Clostridium sensu stricto 10	2	0	0	0	0	0	4	6
Bacteria;Bacteria_none;Firmicutes;Clostridia;Peptostreptococcales-Tissierellales;Anaerovoracaceae;Anaerovoracaceae_uncultured	1	0	0	0	0	0	5	6
Bacteria;Bacteria_none;Proteobacteria;Gammaproteobacteria;Pseudomonadales;Spongiibacteraceae;Zhongshania	4	0	0	1	0	1	0	6
Bacteria;Bacteria_none;Desulfobacterota;Desulfobulbia;Desulfobulbales;Desulfocapsaceae;Desulfofustis	1	2	0	0	0	1	2	6
Bacteria;Bacteria_none;Proteobacteria;Gammaproteobacteria;Pseudomonadales;Spongiibacteraceae;Spongiibacter	1	0	0	0	1	0	4	6
Bacteria;Bacteria_none;Desulfobacterota;Desulfobulbia;Desulfobulbales;Desulfobulbaceae;Desulfobulbaceae_uncultured	0	6	0	0	0	0	0	6
Bacteria;Bacteria_none;Proteobacteria;Gammaproteobacteria;Enterobacterales;Morganellaceae;endosymbionts	3	0	0	0	0	0	3	6
Bacteria;Bacteria_none;Bacteroidota;Bacteroidia;Flavobacteriales;Flavobacteriaceae;Flavirhabdus	0	0	0	2	0	3	1	6
Bacteria;Bacteria_none;Proteobacteria;Gammaproteobacteria;Xanthomonadales;Rhodanobacteraceae;Rhodanobacter	5	0	0	0	0	0	1	6
Bacteria;Bacteria_none;Proteobacteria;Alphaproteobacteria;Rhodobacterales;Rhodobacteraceae;Pelagibaca	3	0	0	3	0	0	0	6
Bacteria;Bacteria_none;Actinobacteriota;Actinobacteria;Micrococcales;Dermatophilaceae;Dermatophilaceae_uncultured	0	0	0	0	6	0	0	6
Bacteria;Bacteria_none;Proteobacteria;Gammaproteobacteria;Diplorickettsiales;Diplorickettsiaceae;Aquicella	2	0	0	2	2	0	0	6
Bacteria;Bacteria_none;Acidobacteriota;Thermoanaerobaculia;Thermoanaerobaculales;Thermoanaerobaculaceae;Subgroup 23	6	0	0	0	0	0	0	6
Bacteria;Bacteria_none;Actinobacteriota;Actinobacteria;Micrococcales;Microbacteriaceae;Microbacterium	0	0	0	1	0	5	0	6
Bacteria;Bacteria_none;Firmicutes;Clostridia;Clostridiales;Clostridiaceae;Hathewaya	1	0	1	0	1	2	1	6
Bacteria;Bacteria_none;Proteobacteria;Gammaproteobacteria;Pseudomonadales;Moraxellaceae;[Agitococcus] lubricus group	3	0	0	1	0	0	2	6
Bacteria;Bacteria_none;Proteobacteria;Gammaproteobacteria;Methylococcales;Cycloclasticaceae;Cycloclasticus	2	0	0	2	0	0	2	6
Bacteria;Bacteria_none;Proteobacteria;Alphaproteobacteria;Rhizobiales;Hyphomicrobiaceae;Hyphomicrobiaceae_uncultured	0	0	0	0	5	0	0	5
Bacteria;Bacteria_none;Firmicutes;Clostridia;Oscillospirales;Ruminococcaceae;Subdoligranulum	0	0	0	0	0	0	5	5
Bacteria;Bacteria_none;Bacteroidota;Bacteroidia;Flavobacteriales;Flavobacteriaceae;Sinomicrobium	1	1	0	1	1	1	0	5
Bacteria;Bacteria_none;Proteobacteria;Alphaproteobacteria;Rhodobacterales;Rhodobacteraceae;Haematobacter	0	0	0	0	1	0	4	5
Bacteria;Bacteria_none;Bacteroidota;Bacteroidia;Flavobacteriales;Flavobacteriaceae;Myroides	1	0	0	0	0	2	2	5
Bacteria;Bacteria_none;Proteobacteria;Alphaproteobacteria;Rhodobacterales;Rhodobacteraceae;Rubrimonas	0	1	0	0	1	1	2	5
Bacteria;Bacteria_none;Bdellovibrionota;Bdellovibrionia;Bdellovibrionales;Bdellovibrionaceae;Bdellovibrio	0	0	0	0	0	0	5	5
Bacteria;Bacteria_none;Proteobacteria;Gammaproteobacteria;Enterobacterales;Pectobacteriaceae;Sodalis	0	0	0	5	0	0	0	5
Bacteria;Bacteria_none;Proteobacteria;Gammaproteobacteria;Enterobacterales;Yersiniaceae;Rahnella1	1	0	0	3	0	1	0	5
Bacteria;Bacteria_none;Proteobacteria;Alphaproteobacteria;Rhodobacterales;Rhodobacteraceae;Tabrizicola	1	0	1	0	1	0	2	5
Bacteria;Bacteria_none;Bacteroidota;Bacteroidia;Flavobacteriales;Flavobacteriaceae;Mesoflavibacter	1	1	0	2	0	0	1	5
Bacteria;Bacteria_none;Firmicutes;Clostridia;Clostridiales;Clostridiaceae;Youngiibacter	1	0	1	0	0	1	2	5
Bacteria;Bacteria_none;Proteobacteria;Gammaproteobacteria;Burkholderiales;Gallionellaceae;Sideroxydans	3	0	0	0	0	0	2	5
Bacteria;Bacteria_none;Firmicutes;Clostridia;Oscillospirales;Hungateiclostridiaceae;UCG-012	0	1	0	0	4	0	0	5
Bacteria;Bacteria_none;Proteobacteria;Gammaproteobacteria;Pseudomonadales;Halomonadaceae;Candidatus Portiera	3	0	0	0	0	0	2	5
Bacteria;Bacteria_none;Proteobacteria;Gammaproteobacteria;Nitrosococcales;Methylophagaceae;Methylophaga	2	0	0	1	0	0	2	5
Bacteria;Bacteria_none;Proteobacteria;Gammaproteobacteria;Xanthomonadales;Xanthomonadaceae;Xanthomonas	2	0	0	0	0	3	0	5
Bacteria;Bacteria_none;Proteobacteria;Gammaproteobacteria;Pseudomonadales;Saccharospirillaceae;Oceanobacter	3	0	0	0	0	0	2	5
Bacteria;Bacteria_none;Proteobacteria;Gammaproteobacteria;Enterobacterales;Vibrionaceae;Enterovibrio	1	0	0	4	0	0	0	5
Bacteria;Bacteria_none;Bacteroidota;Bacteroidia;Flavobacteriales;Flavobacteriaceae;Coenonia	0	0	0	1	0	2	2	5
Bacteria;Bacteria_none;Actinobacteriota;Actinobacteria;Micrococcales;Dermacoccaceae;Allobranchiibius	0	0	0	0	5	0	0	5
Bacteria;Bacteria_none;Proteobacteria;Alphaproteobacteria;Rhodobacterales;Rhodobacteraceae;Thalassococcus	1	0	0	0	0	0	3	4
Bacteria;Bacteria_none;Proteobacteria;Gammaproteobacteria;Burkholderiales;Burkholderiaceae;Cupriavidus	1	0	0	0	3	0	0	4
Bacteria;Bacteria_none;Proteobacteria;Alphaproteobacteria;Rhodobacterales;Rhodobacteraceae;Albimonas	1	2	0	0	0	0	1	4
Bacteria;Bacteria_none;Bacteroidota;Bacteroidia;Flavobacteriales;Flavobacteriaceae;Tamlana	0	1	0	1	0	1	1	4
Bacteria;Bacteria_none;Proteobacteria;Gammaproteobacteria;Burkholderiales;Alcaligenaceae;Bordetella	0	0	0	0	0	0	4	4
Bacteria;Bacteria_none;Proteobacteria;Alphaproteobacteria;Rhodobacterales;Rhodobacteraceae;Cognatiyoonia	0	0	0	0	3	0	1	4
Bacteria;Bacteria_none;Bacteroidota;Bacteroidia;Flavobacteriales;Flavobacteriaceae;Joostella	0	0	0	1	0	3	0	4
Bacteria;Bacteria_none;Proteobacteria;Gammaproteobacteria;Burkholderiales;Nitrosomonadaceae;MND1	0	3	0	0	0	0	1	4
Bacteria;Bacteria_none;Proteobacteria;Gammaproteobacteria;Burkholderiales;Hydrogenophilaceae;Thiobacillus	4	0	0	0	0	0	0	4
Bacteria;Bacteria_none;Actinobacteriota;Actinobacteria;Corynebacteriales;Corynebacteriales Incertae Sedis;Tomitella	0	2	0	0	2	0	0	4
Bacteria;Bacteria_none;Proteobacteria;Alphaproteobacteria;Sphingomonadales;Sphingomonadaceae;Sphingopyxis	2	0	0	0	0	0	2	4
Bacteria;Bacteria_none;Proteobacteria;Gammaproteobacteria;Pseudomonadales;Saccharospirillaceae;Saccharospirillum	4	0	0	0	0	0	0	4
Bacteria;Bacteria_none;Proteobacteria;Gammaproteobacteria;Thiomicrospirales;Thiomicrospiraceae;endosymbionts	1	0	0	1	2	0	0	4
Bacteria;Bacteria_none;Bacteroidota;Bacteroidia;Bacteroidales;Marinifilaceae;Odoribacter	0	0	0	0	4	0	0	4
Bacteria;Bacteria_none;Proteobacteria;Gammaproteobacteria;Cardiobacteriales;Cardiobacteriaceae;Cardiobacteriaceae_uncultured	0	2	0	2	0	0	0	4
Bacteria;Bacteria_none;Proteobacteria;Gammaproteobacteria;Ectothiorhodospirales;Ectothiorhodospiraceae;Ectothiorhodospiraceae_uncultured	1	1	0	0	2	0	0	4
Bacteria;Bacteria_none;Actinobacteriota;Actinobacteria;Micrococcales;Micrococcaceae;Pseudarthrobacter	0	0	0	2	0	0	2	4
Bacteria;Bacteria_none;Proteobacteria;Alphaproteobacteria;Rhodobacterales;Rhodobacteraceae;Rhodovulum	0	0	0	0	0	4	0	4
Bacteria;Bacteria_none;Proteobacteria;Gammaproteobacteria;Halothiobacillales;Halothiobacillaceae;Thiovirga	2	0	0	0	2	0	0	4
Bacteria;Bacteria_none;Proteobacteria;Alphaproteobacteria;Rhodobacterales;Rhodobacteraceae;Roseicyclus	4	0	0	0	0	0	0	4
Bacteria;Bacteria_none;Proteobacteria;Alphaproteobacteria;Rhodobacterales;Rhodobacteraceae;Litorimicrobium	1	0	1	0	0	1	1	4
Bacteria;Bacteria_none;Proteobacteria;Gammaproteobacteria;Chromatiales;Chromatiaceae;Thiohalocapsa	1	0	0	2	0	0	1	4
Bacteria;Bacteria_none;Firmicutes;Bacilli;Lactobacillales;Lactobacillaceae;Lactobacillus	3	0	0	1	0	0	0	4
Bacteria;Bacteria_none;Firmicutes;Bacilli;Bacillales;Planococcaceae;Rummeliibacillus	0	0	0	4	0	0	0	4
Bacteria;Bacteria_none;Proteobacteria;Alphaproteobacteria;Rhodobacterales;Rhodobacteraceae;Rubribacterium	0	2	0	0	0	1	1	4
Bacteria;Bacteria_none;Bacteroidota;Bacteroidia;Flavobacteriales;Flavobacteriaceae;Hoppeia	1	0	0	1	1	1	0	4
Bacteria;Bacteria_none;Proteobacteria;Alphaproteobacteria;Rhodobacterales;Rhodobacteraceae;Jannaschia	0	2	0	0	2	0	0	4
Bacteria;Bacteria_none;Firmicutes;Clostridia;Lachnospirales;Lachnospiraceae;Roseburia	1	0	0	0	0	2	1	4
Bacteria;Bacteria_none;Proteobacteria;Gammaproteobacteria;Burkholderiales;Sulfuricellaceae;Ferritrophicum	3	0	0	0	0	0	0	3
Bacteria;Bacteria_none;Proteobacteria;Gammaproteobacteria;Enterobacterales;Enterobacteriaceae;Raoultella	3	0	0	0	0	0	0	3
Bacteria;Bacteria_none;Proteobacteria;Gammaproteobacteria;Pseudomonadales;Moraxellaceae;Cavicella	2	0	0	0	0	0	1	3
Bacteria;Bacteria_none;Firmicutes;Clostridia;Oscillospirales;Hungateiclostridiaceae;Ercella	0	0	0	0	3	0	0	3
Bacteria;Bacteria_none;Proteobacteria;Gammaproteobacteria;Burkholderiales;Comamonadaceae;Delftia	0	0	0	0	0	0	3	3
Bacteria;Bacteria_none;Firmicutes;Clostridia;Lachnospirales;Lachnospiraceae;[Ruminococcus] torques group	1	0	0	0	0	2	0	3
Bacteria;Bacteria_none;Proteobacteria;Gammaproteobacteria;Enterobacterales;Alteromonadaceae;Glaciecola	1	0	0	2	0	0	0	3
Bacteria;Bacteria_none;Proteobacteria;Gammaproteobacteria;Burkholderiales;Comamonadaceae;Sphaerotilus	2	0	0	1	0	0	0	3
Bacteria;Bacteria_none;Actinobacteriota;Actinobacteria;Kineosporiales;Kineosporiaceae;Angustibacter	0	0	0	0	0	0	3	3
Bacteria;Bacteria_none;Firmicutes;Clostridia;Clostridiales;Clostridiaceae;Clostridium sensu stricto 14	1	1	0	0	0	1	0	3
Bacteria;Bacteria_none;Firmicutes;Clostridia;Lachnospirales;Lachnospiraceae;Lachnospiraceae NK4A136 group	1	1	0	0	0	1	0	3
Bacteria;Bacteria_none;Proteobacteria;Gammaproteobacteria;Burkholderiales;Rhodocyclaceae;Dechloromonas	2	0	0	0	0	0	1	3
Bacteria;Bacteria_none;Bacteroidota;Bacteroidia;Flavobacteriales;Flavobacteriaceae;Siansivirga	0	0	0	0	0	2	1	3
Bacteria;Bacteria_none;Proteobacteria;Gammaproteobacteria;Pseudomonadales;Pseudomonadaceae;Thiopseudomonas	2	0	0	0	0	0	1	3
Bacteria;Bacteria_none;Proteobacteria;Gammaproteobacteria;Enterobacterales;Morganellaceae;Arsenophonus	1	0	0	1	0	1	0	3
Bacteria;Bacteria_none;Proteobacteria;Gammaproteobacteria;Enterobacterales;Aeromonadaceae;Zobellella	0	0	0	3	0	0	0	3
Bacteria;Bacteria_none;Actinobacteriota;Actinobacteria;Frankiales;Geodermatophilaceae;Antricoccus	0	0	0	0	0	2	1	3
Bacteria;Bacteria_none;Proteobacteria;Gammaproteobacteria;Burkholderiales;Nitrosomonadaceae;oc32	0	3	0	0	0	0	0	3
Bacteria;Bacteria_none;Proteobacteria;Alphaproteobacteria;Rhodobacterales;Rhodobacteraceae;Vadicella	1	1	0	0	0	0	1	3
Bacteria;Bacteria_none;Proteobacteria;Gammaproteobacteria;Burkholderiales;Comamonadaceae;Acidovorax	2	1	0	0	0	0	0	3
Bacteria;Bacteria_none;Firmicutes;Bacilli;Bacillales;Planococcaceae;Paenisporosarcina	0	0	0	3	0	0	0	3
Bacteria;Bacteria_none;Proteobacteria;Alphaproteobacteria;Rhodobacterales;Rhodobacteraceae;Roseinatronobacter	0	0	0	1	0	0	2	3
Bacteria;Bacteria_none;Proteobacteria;Gammaproteobacteria;Pseudomonadales;Halomonadaceae;Carnimonas	0	0	0	0	0	1	2	3
Bacteria;Bacteria_none;Bacteroidota;Bacteroidia;Bacteroidales;Bacteroidaceae;Bacteroides	0	0	0	0	3	0	0	3
Bacteria;Bacteria_none;Bacteroidota;Bacteroidia;Flavobacteriales;Flavobacteriaceae;Gelidibacter	0	0	0	2	0	1	0	3
Bacteria;Bacteria_none;Proteobacteria;Alphaproteobacteria;Rhodobacterales;Rhodobacteraceae;Rhodobaca	1	0	0	0	0	0	2	3
Bacteria;Bacteria_none;Firmicutes;Clostridia;Peptostreptococcales-Tissierellales;Peptostreptococcaceae;[Eubacterium] yurii group	0	0	0	0	0	2	1	3
Bacteria;Bacteria_none;Actinobacteriota;Actinobacteria;Streptomycetales;Streptomycetaceae;Streptomyces	0	0	0	3	0	0	0	3
Bacteria;Bacteria_none;Proteobacteria;Gammaproteobacteria;Xanthomonadales;Rhodanobacteraceae;Tahibacter	2	0	0	1	0	0	0	3
Bacteria;Bacteria_none;Bacteroidota;Bacteroidia;Flavobacteriales;Flavobacteriaceae;Flavicella	1	1	0	0	0	1	0	3
Bacteria;Bacteria_none;Proteobacteria;Alphaproteobacteria;Rhodobacterales;Rhodobacteraceae;Oceanibulbus	2	0	0	0	1	0	0	3
Bacteria;Bacteria_none;Bdellovibrionota;Bdellovibrionia;Bacteriovoracales;Bacteriovoracaceae;Peredibacter	0	3	0	0	0	0	0	3
Bacteria;Bacteria_none;Proteobacteria;Alphaproteobacteria;Caulobacterales;Hyphomonadaceae;Robiginitomaculum	0	3	0	0	0	0	0	3
Bacteria;Bacteria_none;Proteobacteria;Gammaproteobacteria;Pseudomonadales;Endozoicomonadaceae;Kistimonas	0	0	0	0	1	0	2	3
Bacteria;Bacteria_none;Actinobacteriota;Acidimicrobiia;Microtrichales;Ilumatobacteraceae;CL500-29 marine group	0	0	0	0	1	2	0	3
Bacteria;Bacteria_none;Proteobacteria;Alphaproteobacteria;Rhodobacterales;Rhodobacteraceae;Halocynthiibacter	1	0	0	0	0	0	2	3
Bacteria;Bacteria_none;Proteobacteria;Alphaproteobacteria;Rhodobacterales;Rhodobacteraceae;Actibacterium	2	1	0	0	0	0	0	3
Bacteria;Bacteria_none;Proteobacteria;Alphaproteobacteria;Rhodobacterales;Rhodobacteraceae;Dinoroseobacter	2	0	0	0	0	0	1	3
Bacteria;Bacteria_none;Bacteroidota;Bacteroidia;Flavobacteriales;Flavobacteriaceae;Psychroflexus	1	0	0	0	0	1	1	3
Bacteria;Bacteria_none;Firmicutes;Bacilli;Erysipelotrichales;Erysipelotrichaceae;Faecalibaculum	3	0	0	0	0	0	0	3
Bacteria;Bacteria_none;Proteobacteria;Gammaproteobacteria;Piscirickettsiales;Piscirickettsiaceae;Candidatus Endoecteinascidia	0	0	0	0	0	0	3	3
Eukaryota;Chloroplastida;Phragmoplastophyta;Embryophyta;Fabales;Fabales_Incertae_sedis;Arachis	3	0	0	0	0	0	0	3
Bacteria;Bacteria_none;Proteobacteria;Alphaproteobacteria;Rhodobacterales;Rhodobacteraceae;Citreicella	3	0	0	0	0	0	0	3
Bacteria;Bacteria_none;Firmicutes;Bacilli;Erysipelotrichales;Erysipelotrichaceae;Holdemanella	2	0	0	0	0	0	1	3
Bacteria;Bacteria_none;Bacteroidota;Bacteroidia;Flavobacteriales;Flavobacteriaceae;Gilvibacter	0	0	0	1	0	2	0	3
Bacteria;Bacteria_none;Proteobacteria;Gammaproteobacteria;Xanthomonadales;Rhodanobacteraceae;Pseudofulvimonas	1	0	0	1	0	0	1	3
Bacteria;Bacteria_none;Firmicutes;Clostridia;Clostridiales;Clostridiaceae;Anaerobacter	1	0	0	0	1	1	0	3
Bacteria;Bacteria_none;Proteobacteria;Alphaproteobacteria;Rhodobacterales;Rhodobacteraceae;Sagittula	1	0	0	0	0	1	1	3
Bacteria;Bacteria_none;Proteobacteria;Gammaproteobacteria;Enterobacterales;Shewanellaceae;Ferrimonas	2	0	0	1	0	0	0	3
Bacteria;Bacteria_none;Firmicutes;Bacilli;Paenibacillales;Paenibacillaceae;Paenibacillus	1	0	0	1	1	0	0	3
Bacteria;Bacteria_none;Firmicutes;Bacilli;Staphylococcales;Staphylococcaceae;Salinicoccus	0	0	0	3	0	0	0	3
Bacteria;Bacteria_none;Proteobacteria;Gammaproteobacteria;Salinisphaerales;Solimonadaceae;Polycyclovorans	3	0	0	0	0	0	0	3
Bacteria;Bacteria_none;Proteobacteria;Gammaproteobacteria;Acidithiobacillales;Acidithiobacillaceae;Acidithiobacillus	3	0	0	0	0	0	0	3
Bacteria;Bacteria_none;Bacteroidota;Bacteroidia;Flavobacteriales;Flavobacteriaceae;Jejuia	0	0	0	3	0	0	0	3
Bacteria;Bacteria_none;Proteobacteria;Gammaproteobacteria;Enterobacterales;Hafniaceae;Edwardsiella	1	0	0	0	0	1	0	2
Bacteria;Bacteria_none;Proteobacteria;Gammaproteobacteria;Methylococcales;Methylomonadaceae;pLW-20	1	0	0	1	0	0	0	2
Bacteria;Bacteria_none;Proteobacteria;Gammaproteobacteria;Methylococcales;Methylomonadaceae;Crenothrix	2	0	0	0	0	0	0	2
Bacteria;Bacteria_none;Bacteroidota;Bacteroidia;Flavobacteriales;Flavobacteriaceae;Pibocella	0	0	0	1	0	1	0	2
Bacteria;Bacteria_none;Proteobacteria;Gammaproteobacteria;Pseudomonadales;Cellvibrionaceae;Umboniibacter	0	0	0	0	1	0	1	2
Bacteria;Bacteria_none;Proteobacteria;Gammaproteobacteria;Pseudomonadales;Halomonadaceae;Salicola	1	0	0	0	0	1	0	2
Bacteria;Bacteria_none;Proteobacteria;Gammaproteobacteria;Methylococcales;Methylomonadaceae;Milano-WF1B-03	0	0	0	0	2	0	0	2
Bacteria;Bacteria_none;Proteobacteria;Gammaproteobacteria;Enterobacterales;Pasteurellaceae;Pasteurella	2	0	0	0	0	0	0	2
Bacteria;Bacteria_none;Bacteroidota;Bacteroidia;Flavobacteriales;Flavobacteriaceae;Planktosalinus	0	1	0	0	0	1	0	2
Bacteria;Bacteria_none;Proteobacteria;Gammaproteobacteria;Enterobacterales;Pasteurellaceae;Phocoenobacter	1	0	0	0	0	1	0	2
Bacteria;Bacteria_none;Proteobacteria;Gammaproteobacteria;Enterobacterales;Pectobacteriaceae;Brenneria	0	0	0	0	1	1	0	2
Bacteria;Bacteria_none;Proteobacteria;Gammaproteobacteria;Enterobacterales;Pasteurellaceae;Mannheimia	2	0	0	0	0	0	0	2
Bacteria;Bacteria_none;Proteobacteria;Gammaproteobacteria;Enterobacterales;Morganellaceae;Providencia	0	0	0	2	0	0	0	2
Bacteria;Bacteria_none;Proteobacteria;Gammaproteobacteria;Enterobacterales;Pasteurellaceae;Aggregatibacter	2	0	0	0	0	0	0	2
Bacteria;Bacteria_none;Proteobacteria;Gammaproteobacteria;Enterobacterales;Morganellaceae;Xenorhabdus	0	0	0	2	0	0	0	2
Bacteria;Bacteria_none;Proteobacteria;Gammaproteobacteria;Enterobacterales;Moritellaceae;Paramoritella	0	0	0	2	0	0	0	2
Bacteria;Bacteria_none;Proteobacteria;Gammaproteobacteria;Enterobacterales;Pasteurellaceae;Rodentibacter	0	0	0	1	0	0	1	2
Bacteria;Bacteria_none;Proteobacteria;Gammaproteobacteria;Pseudomonadales;Halomonadaceae;Terasakiispira	1	0	0	0	1	0	0	2
Bacteria;Bacteria_none;Proteobacteria;Gammaproteobacteria;Enterobacterales;Pectobacteriaceae;Dickeya	1	0	0	1	0	0	0	2
Bacteria;Bacteria_none;Proteobacteria;Gammaproteobacteria;Pseudomonadales;Hahellaceae;Hahella	0	0	0	0	0	0	2	2
Bacteria;Bacteria_none;Proteobacteria;Gammaproteobacteria;Enterobacterales;Shewanellaceae;Psychrobium	0	0	0	1	0	0	1	2
Bacteria;Bacteria_none;Firmicutes;Bacilli;Bacillales;Planococcaceae;Kurthia	0	0	0	2	0	0	0	2
Bacteria;Bacteria_none;Actinobacteriota;Coriobacteriia;Coriobacteriales;Coriobacteriales Incertae Sedis;Phoenicibacter	2	0	0	0	0	0	0	2
Bacteria;Bacteria_none;Firmicutes;Bacilli;Mycoplasmatales;Mycoplasmataceae;Mycoplasma	1	0	0	1	0	0	0	2
Bacteria;Bacteria_none;Actinobacteriota;Actinobacteria;Micrococcales;Intrasporangiaceae;Ornithinimicrobium	0	0	0	0	0	0	2	2
Bacteria;Bacteria_none;Proteobacteria;Gammaproteobacteria;Enterobacterales;Enterobacterales Incertae Sedis;Alkalimonas	0	0	0	2	0	0	0	2
Bacteria;Bacteria_none;Firmicutes;Bacilli;Bacillales;Planococcaceae;Chungangia	1	0	0	1	0	0	0	2
Bacteria;Bacteria_none;Firmicutes;Bacilli;Lactobacillales;Streptococcaceae;Lactococcus	2	0	0	0	0	0	0	2
Bacteria;Bacteria_none;Proteobacteria;Gammaproteobacteria;Enterobacterales;Erwiniaceae;Erwinia	0	0	0	0	0	1	1	2
Bacteria;Bacteria_none;Proteobacteria;Gammaproteobacteria;Enterobacterales;Vibrionaceae;Catenococcus	0	0	0	1	0	0	1	2
Bacteria;Bacteria_none;Proteobacteria;Gammaproteobacteria;Enterobacterales;Morganellaceae;Candidatus Baumannia	1	0	0	0	0	0	1	2
Bacteria;Bacteria_none;Actinobacteriota;Actinobacteria;Propionibacteriales;Propionibacteriaceae;Pseudopropionibacterium	1	0	0	1	0	0	0	2
Bacteria;Bacteria_none;Proteobacteria;Gammaproteobacteria;Francisellales;Francisellaceae;Francisellaceae_uncultured	1	0	0	1	0	0	0	2
Bacteria;Bacteria_none;Actinobacteriota;Actinobacteria;Micrococcales;Micrococcaceae;Auritidibacter	0	0	0	2	0	0	0	2
Bacteria;Bacteria_none;Proteobacteria;Gammaproteobacteria;Pseudomonadales;Litoricolaceae;Litoricola	0	0	0	0	1	0	1	2
Bacteria;Bacteria_none;Proteobacteria;Gammaproteobacteria;Enterobacterales;Enterobacteriaceae;Buttiauxella	2	0	0	0	0	0	0	2
Bacteria;Bacteria_none;Proteobacteria;Gammaproteobacteria;Pseudomonadales;Cellvibrionaceae;Aestuariicella	1	0	0	0	0	0	1	2
Bacteria;Bacteria_none;Bacteroidota;Bacteroidia;Flavobacteriales;Flavobacteriaceae;Seonamhaeicola	0	0	0	1	0	1	0	2
Bacteria;Bacteria_none;Proteobacteria;Gammaproteobacteria;Steroidobacterales;Steroidobacteraceae;Steroidobacter	1	0	0	1	0	0	0	2
Bacteria;Bacteria_none;Proteobacteria;Gammaproteobacteria;Pseudomonadales;Saccharospirillaceae;Reinekea	1	0	0	0	0	1	0	2
Bacteria;Bacteria_none;Bacteroidota;Bacteroidia;Flavobacteriales;Flavobacteriaceae;Spongiivirga	1	0	0	0	0	1	0	2
Bacteria;Bacteria_none;Proteobacteria;Alphaproteobacteria;Rhodobacterales;Rhodobacteraceae;Limibaculum	0	1	0	0	0	1	0	2
Bacteria;Bacteria_none;Proteobacteria;Gammaproteobacteria;Burkholderiales;Burkholderiaceae;Ralstonia	0	0	1	0	0	0	1	2
Bacteria;Bacteria_none;Bacteroidota;Bacteroidia;Flavobacteriales;Flavobacteriaceae;Ascidiimonas	1	0	0	1	0	0	0	2
Bacteria;Bacteria_none;Proteobacteria;Gammaproteobacteria;Burkholderiales;Alcaligenaceae;Castellaniella	2	0	0	0	0	0	0	2
Bacteria;Bacteria_none;Proteobacteria;Alphaproteobacteria;Caulobacterales;Hyphomonadaceae;Hyphomonas	1	0	0	0	0	0	1	2
Bacteria;Bacteria_none;Proteobacteria;Alphaproteobacteria;Caulobacterales;Hyphomonadaceae;Hyphomonadaceae_uncultured	0	2	0	0	0	0	0	2
Bacteria;Bacteria_none;Bdellovibrionota;Oligoflexia;Oligoflexales;Oligoflexaceae;Pseudobacteriovorax	1	0	0	0	1	0	0	2
Bacteria;Bacteria_none;Firmicutes;Clostridia;Oscillospirales;Oscillospiraceae;Flavonifractor	0	0	0	0	0	2	0	2
Bacteria;Bacteria_none;Proteobacteria;Alphaproteobacteria;Rhodobacterales;Rhodobacteraceae;Paenirhodobacter	0	1	0	0	0	0	1	2
Bacteria;Bacteria_none;Firmicutes;Clostridia;Oscillospirales;Ruminococcaceae;Incertae Sedis	2	0	0	0	0	0	0	2
Bacteria;Bacteria_none;Bacteroidota;Bacteroidia;Flavobacteriales;Flavobacteriaceae;Jejudonia	1	0	0	0	0	0	1	2
Bacteria;Bacteria_none;Proteobacteria;Gammaproteobacteria;Burkholderiales;Comamonadaceae;Rhodoferax	1	0	0	0	0	0	1	2
Bacteria;Bacteria_none;Proteobacteria;Gammaproteobacteria;Enterobacterales;Celerinatantimonadaceae;Celerinatantimonas	1	0	0	1	0	0	0	2
Bacteria;Bacteria_none;Proteobacteria;Alphaproteobacteria;Rhodobacterales;Rhodobacteraceae;Sediminimonas	1	0	0	0	0	1	0	2
Bacteria;Bacteria_none;Bacteroidota;Bacteroidia;Flavobacteriales;Flavobacteriaceae;Hyunsoonleella	0	0	0	0	0	1	1	2
Bacteria;Bacteria_none;Bacteroidota;Bacteroidia;Flavobacteriales;Flavobacteriaceae;Vitellibacter	1	0	0	0	0	1	0	2
Bacteria;Bacteria_none;Proteobacteria;Alphaproteobacteria;Rhodobacterales;Rhodobacteraceae;Roseobacter clade Marinomonas lineage	1	0	0	0	0	0	1	2
Bacteria;Bacteria_none;Bacteroidota;Bacteroidia;Flavobacteriales;Flavobacteriaceae;Croceibacter	0	0	0	0	0	1	1	2
Bacteria;Bacteria_none;Proteobacteria;Alphaproteobacteria;Rhodobacterales;Rhodobacteraceae;Rhodobaculum	1	0	0	0	0	0	1	2
Bacteria;Bacteria_none;Bacteroidota;Bacteroidia;Flavobacteriales;Flavobacteriaceae;Gangjinia	0	0	0	1	0	1	0	2
Bacteria;Bacteria_none;Proteobacteria;Alphaproteobacteria;Rhodobacterales;Rhodobacteraceae;Primorskyibacter	1	1	0	0	0	0	0	2
Bacteria;Bacteria_none;Proteobacteria;Gammaproteobacteria;Xanthomonadales;Xanthomonadaceae;Lysobacter	0	1	0	0	0	0	1	2
Bacteria;Bacteria_none;Bacteroidota;Bacteroidia;Flavobacteriales;Flavobacteriaceae;Gaetbulibacter	1	0	0	1	0	0	0	2
Bacteria;Bacteria_none;Proteobacteria;Alphaproteobacteria;Rhodobacterales;Rhodobacteraceae;Pontibaca	1	1	0	0	0	0	0	2
Bacteria;Bacteria_none;Proteobacteria;Gammaproteobacteria;Pseudomonadales;Saccharospirillaceae;Oleibacter	0	0	0	2	0	0	0	2
Bacteria;Bacteria_none;Proteobacteria;Gammaproteobacteria;Burkholderiales;Chromobacteriaceae;Chromobacterium	1	0	0	1	0	0	0	2
Bacteria;Bacteria_none;Proteobacteria;Gammaproteobacteria;Burkholderiales;Gallionellaceae;Gallionella	1	0	0	1	0	0	0	2
Bacteria;Bacteria_none;Proteobacteria;Alphaproteobacteria;Rhodobacterales;Rhodobacteraceae;Jhaorihella	0	1	0	0	0	0	1	2
Eukaryota;Chloroplastida;Phragmoplastophyta;Embryophyta;Myrtales;Myrtales_Incertae_sedis;Eucalyptus	2	0	0	0	0	0	0	2
Bacteria;Bacteria_none;Proteobacteria;Gammaproteobacteria;Enterobacterales;Alteromonadaceae;Alishewanella	0	0	0	2	0	0	0	2
Eukaryota;Alveolata;Apicomplexa;Aconoidasida;Haemosporoidia;Haemosporoidia_Incertae_sedis;Plasmodium	0	1	1	0	0	0	0	2
Bacteria;Bacteria_none;Firmicutes;Clostridia;Lachnospirales;Lachnospiraceae;Lachnospiraceae NC2004 group	1	0	0	0	0	0	1	2
Bacteria;Bacteria_none;Proteobacteria;Gammaproteobacteria;Ectothiorhodospirales;Ectothiorhodospiraceae;Thiogranum	2	0	0	0	0	0	0	2
Bacteria;Bacteria_none;Firmicutes;Clostridia;Lachnospirales;Lachnospiraceae;Marvinbryantia	0	0	0	1	0	1	0	2
Bacteria;Bacteria_none;Proteobacteria;Gammaproteobacteria;Diplorickettsiales;Diplorickettsiaceae;Diplorickettsiaceae_uncultured	1	0	0	1	0	0	0	2
Bacteria;Bacteria_none;Proteobacteria;Alphaproteobacteria;Rhodobacterales;Rhodobacteraceae;Aestuariicoccus	2	0	0	0	0	0	0	2
Bacteria;Bacteria_none;Proteobacteria;Alphaproteobacteria;Rhodobacterales;Rhodobacteraceae;Falsirhodobacter	1	0	0	0	0	1	0	2
Bacteria;Bacteria_none;Proteobacteria;Alphaproteobacteria;Rhodobacterales;Rhodobacteraceae;Flavimaricola	0	2	0	0	0	0	0	2
Bacteria;Bacteria_none;Proteobacteria;Gammaproteobacteria;Burkholderiales;Hydrogenophilaceae;Hydrogenophilaceae_uncultured	2	0	0	0	0	0	0	2
Bacteria;Bacteria_none;Proteobacteria;Alphaproteobacteria;Rhodobacterales;Rhodobacteraceae;Halodurantibacterium	0	0	0	0	0	1	1	2
Bacteria;Bacteria_none;Proteobacteria;Gammaproteobacteria;Xanthomonadales;Xanthomonadaceae;Luteimonas	0	0	0	2	0	0	0	2
Bacteria;Bacteria_none;Proteobacteria;Gammaproteobacteria;Pseudomonadales;Pseudohongiellaceae;Pseudospirillum	0	0	0	0	0	0	2	2
Bacteria;Bacteria_none;Firmicutes;Bacilli;Erysipelotrichales;Erysipelotrichaceae;Faecalitalea	1	0	0	0	0	0	1	2
Bacteria;Bacteria_none;Proteobacteria;Alphaproteobacteria;Rhodobacterales;Rhodobacteraceae;Lentibacter	1	1	0	0	0	0	0	2
Bacteria;Bacteria_none;Actinobacteriota;Acidimicrobiia;Microtrichales;Ilumatobacteraceae;Ilumatobacteraceae_uncultured	0	0	0	0	0	2	0	2
Bacteria;Bacteria_none;Bacteroidota;Bacteroidia;Flavobacteriales;Crocinitomicaceae;Salinirepens	0	0	0	0	2	0	0	2
Bacteria;Bacteria_none;Firmicutes;Bacilli;Erysipelotrichales;Erysipelatoclostridiaceae;Erysipelatoclostridiaceae_uncultured	0	1	0	0	0	0	0	1
Bacteria;Bacteria_none;Bacteroidota;Bacteroidia;Flavobacteriales;Weeksellaceae;Chryseobacterium	1	0	0	0	0	0	0	1
Bacteria;Bacteria_none;Actinobacteriota;Acidimicrobiia;Microtrichales;Iamiaceae;Iamia	0	0	1	0	0	0	0	1
Bacteria;Bacteria_none;Actinobacteriota;Actinobacteria;Micromonosporales;Micromonosporaceae;Micromonospora	0	0	0	1	0	0	0	1
Eukaryota;Amoebozoa;Amoebozoa_Incertae_sedis;Discosea;Centramoebida;Centramoebida_Incertae_sedis;Acanthamoeba	0	1	0	0	0	0	0	1
Bacteria;Bacteria_none;Actinobacteriota;Actinobacteria;Micrococcales;Microbacteriaceae;Cryobacterium	0	0	0	0	0	1	0	1
Bacteria;Bacteria_none;Firmicutes;Bacilli;Erysipelotrichales;Erysipelotrichaceae;Bulleidia	0	0	0	1	0	0	0	1
Bacteria;Bacteria_none;Actinobacteriota;Acidimicrobiia;Microtrichales;Microtrichaceae;IMCC26207	0	0	0	0	1	0	0	1
Bacteria;Bacteria_none;Verrucomicrobiota;Verrucomicrobiae;Verrucomicrobiales;Rubritaleaceae;Rubritaleaceae_uncultured	0	0	1	0	0	0	0	1
Bacteria;Bacteria_none;Proteobacteria;Gammaproteobacteria;Pseudomonadales;Cellvibrionaceae;Pseudomaricurvus	0	0	0	0	0	1	0	1
Bacteria;Bacteria_none;Firmicutes;Bacilli;Entomoplasmatales;Entomoplasmatales_Incertae_sedis;Candidatus Spiroplasma	1	0	0	0	0	0	0	1
Bacteria;Bacteria_none;Actinobacteriota;Actinobacteria;Micrococcales;Micrococcaceae;Micrococcus	0	0	0	0	0	1	0	1
Bacteria;Bacteria_none;Actinobacteriota;Actinobacteria;Micrococcales;Microbacteriaceae;Marisediminicola	0	0	0	0	0	1	0	1
Bacteria;Bacteria_none;Proteobacteria;Gammaproteobacteria;Xanthomonadales;Xanthomonadaceae;Xanthomonadaceae_uncultured	0	0	0	1	0	0	0	1
Bacteria;Bacteria_none;Verrucomicrobiota;Verrucomicrobiae;Verrucomicrobiales;Rubritaleaceae;DBS1	1	0	0	0	0	0	0	1
Bacteria;Bacteria_none;Proteobacteria;Gammaproteobacteria;Xanthomonadales;Xanthomonadaceae;Pseudoxanthomonas	0	0	0	1	0	0	0	1
Bacteria;Bacteria_none;Proteobacteria;Gammaproteobacteria;Pseudomonadales;Cellvibrionaceae;Marinagarivorans	0	0	0	1	0	0	0	1
Bacteria;Bacteria_none;Proteobacteria;Gammaproteobacteria;Thiomicrospirales;Thiomicrospiraceae;Thiomicrospira	0	0	0	1	0	0	0	1
Bacteria;Bacteria_none;Bacteroidota;Bacteroidia;Flavobacteriales;Flavobacteriaceae;Robertkochia	0	0	0	1	0	0	0	1
Bacteria;Bacteria_none;Proteobacteria;Gammaproteobacteria;Pseudomonadales;Nitrincolaceae;Neptunomonas	0	0	0	0	0	0	1	1
Bacteria;Bacteria_none;Actinobacteriota;Actinobacteria;Corynebacteriales;Tsukamurellaceae;Tsukamurella	0	0	0	1	0	0	0	1
Bacteria;Bacteria_none;Desulfobacterota;Desulfobulbia;Desulfobulbales;Desulfocapsaceae;Desulfoprunum	0	1	0	0	0	0	0	1
Bacteria;Bacteria_none;Actinobacteriota;Actinobacteria;Frankiales;Sporichthyaceae;hgcI clade	0	0	0	1	0	0	0	1
Bacteria;Bacteria_none;Bacteroidota;Bacteroidia;Flavobacteriales;Flavobacteriaceae;Spongiiferula	0	0	0	1	0	0	0	1
Bacteria;Bacteria_none;Firmicutes;Bacilli;Acholeplasmatales;Acholeplasmataceae;Acholeplasma	1	0	0	0	0	0	0	1
Bacteria;Bacteria_none;Firmicutes;Bacilli;Acholeplasmatales;Acholeplasmataceae;Candidatus Phytoplasma	0	0	0	1	0	0	0	1
Bacteria;Bacteria_none;Actinobacteriota;Actinobacteria;Micrococcales;Intrasporangiaceae;Knoellia	0	0	0	0	0	1	0	1
Bacteria;Bacteria_none;Proteobacteria;Gammaproteobacteria;Pseudomonadales;Saccharospirillaceae;Litoribrevibacter	0	0	0	1	0	0	0	1
Bacteria;Bacteria_none;Actinobacteriota;Actinobacteria;Micrococcales;Bogoriellaceae;Georgenia	0	0	0	0	0	1	0	1
Bacteria;Bacteria_none;Firmicutes;Bacilli;Bacillales;Bacillaceae;Halobacillus	0	0	0	1	0	0	0	1
Bacteria;Bacteria_none;Actinobacteriota;Actinobacteria;Micrococcales;Brevibacteriaceae;Brevibacterium	0	0	0	1	0	0	0	1
Bacteria;Bacteria_none;Firmicutes;Bacilli;Bacillales;Bacillaceae;Anoxybacillus	0	0	0	1	0	0	0	1
Bacteria;Bacteria_none;Firmicutes;Bacilli;Bacillales;Bacillaceae;Fictibacillus	0	0	0	1	0	0	0	1
Bacteria;Bacteria_none;Actinobacteriota;Actinobacteria;Micrococcales;Cellulomonadaceae;Pseudactinotalea	0	0	0	1	0	0	0	1
Bacteria;Bacteria_none;Proteobacteria;Gammaproteobacteria;Pseudomonadales;Saccharospirillaceae;Litoribacillus	1	0	0	0	0	0	0	1
Bacteria;Bacteria_none;Firmicutes;Bacilli;Bacillales;Bacillaceae;Ureibacillus	0	0	0	1	0	0	0	1
Bacteria;Bacteria_none;Proteobacteria;Gammaproteobacteria;Xanthomonadales;Rhodanobacteraceae;Rhodanobacteraceae_uncultured	0	0	0	0	0	0	1	1
Bacteria;Bacteria_none;Desulfobacterota;Desulfobacteria;Desulfobacterales;Desulfosarcinaceae;Desulfosarcinaceae_uncultured	0	0	0	0	1	0	0	1
Bacteria;Bacteria_none;Proteobacteria;Gammaproteobacteria;Xanthomonadales;Rhodanobacteraceae;Ahniella	1	0	0	0	0	0	0	1
Bacteria;Bacteria_none;Calditrichota;Calditrichia;Calditrichales;Calditrichaceae;JdFR-76	1	0	0	0	0	0	0	1
Bacteria;Bacteria_none;Campylobacterota;Campylobacteria;Campylobacterales;Arcobacteraceae;Halarcobacter	0	1	0	0	0	0	0	1
Bacteria;Bacteria_none;Campylobacterota;Campylobacteria;Campylobacterales;Arcobacteraceae;Pseudarcobacter	0	0	0	0	0	0	1	1
Bacteria;Bacteria_none;Campylobacterota;Campylobacteria;Campylobacterales;Campylobacteraceae;Campylobacter	1	0	0	0	0	0	0	1
Bacteria;Bacteria_none;Cyanobacteria;Cyanobacteriia;Cyanobacteriales;Phormidiaceae;Phormidium IAM M-71	0	0	0	0	0	1	0	1
Bacteria;Bacteria_none;Proteobacteria;Gammaproteobacteria;Pseudomonadales;Thioglobaceae;Candidatus Vesicomyosocius	0	0	0	0	0	1	0	1
Bacteria;Bacteria_none;Proteobacteria;Gammaproteobacteria;Pseudomonadales;Halomonadaceae;Modicisalibacter	0	0	0	0	0	0	1	1
Bacteria;Bacteria_none;Proteobacteria;Gammaproteobacteria;Pseudomonadales;Thioglobaceae;Candidatus Thioglobus	0	0	0	0	0	1	0	1
Bacteria;Bacteria_none;Desulfobacterota;Desulfobulbia;Desulfobulbales;Desulfobulbaceae;Candidatus Electronema	1	0	0	0	0	0	0	1
Bacteria;Bacteria_none;Actinobacteriota;Actinobacteria;Micrococcales;Intrasporangiaceae;Pedococcus-Phycicoccus	0	0	0	0	0	1	0	1
Bacteria;Bacteria_none;Proteobacteria;Gammaproteobacteria;Pseudomonadales;Halomonadaceae;Kushneria	1	0	0	0	0	0	0	1
Bacteria;Bacteria_none;Actinobacteriota;Actinobacteria;Corynebacteriales;Nocardiaceae;Gordonia	0	0	0	1	0	0	0	1
Bacteria;Bacteria_none;Proteobacteria;Gammaproteobacteria;Pseudomonadales;Halomonadaceae;Marinospirillum	0	0	0	0	0	0	1	1
Bacteria;Bacteria_none;Proteobacteria;Gammaproteobacteria;Pseudomonadales;Pseudomonadaceae;Oblitimonas	0	0	0	0	0	0	1	1
Bacteria;Bacteria_none;Proteobacteria;Alphaproteobacteria;Rhodobacterales;Rhodobacteraceae;Amaricoccus	0	0	0	0	0	0	1	1
Bacteria;Bacteria_none;Proteobacteria;Gammaproteobacteria;Pseudomonadales;Cellvibrionaceae;Candidatus Endobugula	1	0	0	0	0	0	0	1
Bacteria;Bacteria_none;Bacteroidota;Bacteroidia;Flavobacteriales;Flavobacteriaceae;Ichthyenterobacterium	1	0	0	0	0	0	0	1
Bacteria;Bacteria_none;Bacteroidota;Bacteroidia;Flavobacteriales;Flavobacteriaceae;Zunongwangia	0	0	0	1	0	0	0	1
Bacteria;Bacteria_none;Firmicutes;Clostridia;Peptostreptococcales-Tissierellales;Anaerovoracaceae;Mogibacterium	0	0	0	0	0	0	1	1
Bacteria;Bacteria_none;Proteobacteria;Alphaproteobacteria;Rhodobacterales;Rhodobacteraceae;WDS1C4	0	0	0	0	0	1	0	1
Bacteria;Bacteria_none;Firmicutes;Clostridia;Oscillospirales;Ruminococcaceae;Pygmaiobacter	1	0	0	0	0	0	0	1
Bacteria;Bacteria_none;Firmicutes;Clostridia;Oscillospirales;Ruminococcaceae;Caproiciproducens	1	0	0	0	0	0	0	1
Bacteria;Bacteria_none;Firmicutes;Clostridia;Oscillospirales;Ruminococcaceae;CAG-352	0	0	0	1	0	0	0	1
Bacteria;Bacteria_none;Proteobacteria;Gammaproteobacteria;Arenicellales;Arenicellaceae;Candidatus Thiosymbion	1	0	0	0	0	0	0	1
Bacteria;Bacteria_none;Proteobacteria;Gammaproteobacteria;Beggiatoales;Beggiatoaceae;Beggiatoaceae_uncultured	1	0	0	0	0	0	0	1
Bacteria;Bacteria_none;Firmicutes;Clostridia;Oscillospirales;Hungateiclostridiaceae;Ruminiclostridium	1	0	0	0	0	0	0	1
Bacteria;Bacteria_none;Proteobacteria;Gammaproteobacteria;Burkholderiales;Alcaligenaceae;Alcaligenaceae_uncultured	0	0	0	0	0	0	1	1
Bacteria;Bacteria_none;Proteobacteria;Gammaproteobacteria;Burkholderiales;Alcaligenaceae;Alcaligenes	0	0	0	0	0	0	1	1
Bacteria;Bacteria_none;Proteobacteria;Gammaproteobacteria;Burkholderiales;Alcaligenaceae;GKS98 freshwater group	1	0	0	0	0	0	0	1
Bacteria;Bacteria_none;Proteobacteria;Gammaproteobacteria;Burkholderiales;Aquaspirillaceae;Aquaspirillum	1	0	0	0	0	0	0	1
Bacteria;Bacteria_none;Bacteroidota;Bacteroidia;Flavobacteriales;Flavobacteriaceae;Leeuwenhoekiella	0	0	0	0	0	1	0	1
Bacteria;Bacteria_none;Firmicutes;Clostridia;Oscillospirales;Hungateiclostridiaceae;Fastidiosipila	0	0	0	0	1	0	0	1
Bacteria;Bacteria_none;Proteobacteria;Gammaproteobacteria;Burkholderiales;Comamonadaceae;Comamonadaceae_uncultured	0	0	0	0	1	0	0	1
Bacteria;Bacteria_none;Proteobacteria;Gammaproteobacteria;Burkholderiales;Comamonadaceae;Comamonas	0	0	1	0	0	0	0	1
Bacteria;Bacteria_none;Proteobacteria;Gammaproteobacteria;Burkholderiales;Comamonadaceae;Limnohabitans	1	0	0	0	0	0	0	1
Bacteria;Bacteria_none;Proteobacteria;Gammaproteobacteria;Burkholderiales;Comamonadaceae;Pelomonas	0	1	0	0	0	0	0	1
Bacteria;Bacteria_none;Proteobacteria;Gammaproteobacteria;Burkholderiales;Comamonadaceae;Polaromonas	0	0	0	1	0	0	0	1
Bacteria;Bacteria_none;Proteobacteria;Gammaproteobacteria;Burkholderiales;Comamonadaceae;RS62 marine group	0	0	0	1	0	0	0	1
Bacteria;Bacteria_none;Proteobacteria;Gammaproteobacteria;Burkholderiales;Comamonadaceae;Rhizobacter	0	0	0	0	1	0	0	1
Bacteria;Bacteria_none;Proteobacteria;Gammaproteobacteria;Burkholderiales;Methylophilaceae;Methylotenera	1	0	0	0	0	0	0	1
Bacteria;Bacteria_none;Firmicutes;Clostridia;Lachnospirales;Lachnospiraceae;[Eubacterium] hallii group	1	0	0	0	0	0	0	1
Bacteria;Bacteria_none;Proteobacteria;Gammaproteobacteria;Burkholderiales;Neisseriaceae;Neisseriaceae_uncultured	1	0	0	0	0	0	0	1
Bacteria;Bacteria_none;Firmicutes;Clostridia;Lachnospirales;Lachnospiraceae;[Eubacterium] eligens group	0	0	0	0	0	1	0	1
Bacteria;Bacteria_none;Proteobacteria;Gammaproteobacteria;Burkholderiales;Oxalobacteraceae;Candidatus Profftella	1	0	0	0	0	0	0	1
Bacteria;Bacteria_none;Firmicutes;Clostridia;Peptostreptococcales-Tissierellales;Family XI;Family XI_uncultured	1	0	0	0	0	0	0	1
Bacteria;Bacteria_none;Proteobacteria;Alphaproteobacteria;Rhodobacterales;Rhodobacteraceae;Seohaeicola	0	0	0	0	0	1	0	1
Bacteria;Bacteria_none;Actinobacteriota;Actinobacteria;Propionibacteriales;Propionibacteriaceae;Aestuariimicrobium	0	0	0	0	0	1	0	1
Bacteria;Bacteria_none;Proteobacteria;Alphaproteobacteria;Rhodobacterales;Rhodobacteraceae;Salinihabitans	0	0	0	0	0	0	1	1
Bacteria;Bacteria_none;Bacteroidota;Bacteroidia;Flavobacteriales;Flavobacteriaceae;Aureisphaera	0	0	0	0	0	1	0	1
Bacteria;Bacteria_none;Proteobacteria;Alphaproteobacteria;Rhodobacterales;Rhodobacteraceae;Cereibacter	0	0	0	0	0	0	1	1
Bacteria;Bacteria_none;Proteobacteria;Alphaproteobacteria;Rhodobacterales;Rhodobacteraceae;Citreimonas	0	1	0	0	0	0	0	1
Bacteria;Bacteria_none;Proteobacteria;Alphaproteobacteria;Rhodobacterales;Rhodobacteraceae;Albidovulum	0	0	0	0	0	1	0	1
Bacteria;Bacteria_none;Proteobacteria;Alphaproteobacteria;Rhodobacterales;Rhodobacteraceae;Confluentimicrobium	1	0	0	0	0	0	0	1
Bacteria;Bacteria_none;Proteobacteria;Alphaproteobacteria;Rhodobacterales;Rhodobacteraceae;Cribrihabitans	0	0	0	0	0	0	1	1
Bacteria;Bacteria_none;Proteobacteria;Alphaproteobacteria;Rhodobacterales;Rhodobacteraceae;Gemmobacter	0	1	0	0	0	0	0	1
Bacteria;Bacteria_none;Proteobacteria;Alphaproteobacteria;Rhodobacterales;Rhodobacteraceae;Halovulum	0	1	0	0	0	0	0	1
Bacteria;Bacteria_none;Proteobacteria;Alphaproteobacteria;Rhodobacterales;Rhodobacteraceae;Ketogulonicigenium	0	0	0	0	0	0	1	1
Bacteria;Bacteria_none;Bacteroidota;Bacteroidia;Flavobacteriales;Flavobacteriaceae;Citreitalea	0	0	0	0	0	0	1	1
Bacteria;Bacteria_none;Proteobacteria;Alphaproteobacteria;Rhodobacterales;Rhodobacteraceae;Limimaricola	0	1	0	0	0	0	0	1
Bacteria;Bacteria_none;Proteobacteria;Alphaproteobacteria;Rhodobacterales;Rhodobacteraceae;Lutimaribacter	0	0	0	0	0	1	0	1
Bacteria;Bacteria_none;Proteobacteria;Alphaproteobacteria;Rhodobacterales;Rhodobacteraceae;Marinovum	1	0	0	0	0	0	0	1
Bacteria;Bacteria_none;Proteobacteria;Alphaproteobacteria;Rhodobacterales;Rhodobacteraceae;Marivivens	0	1	0	0	0	0	0	1
Bacteria;Bacteria_none;Proteobacteria;Alphaproteobacteria;Rhodobacterales;Rhodobacteraceae;Nautella	0	1	0	0	0	0	0	1
Bacteria;Bacteria_none;Planctomycetota;Planctomycetes;Pirellulales;Pirellulaceae;Thermogutta	1	0	0	0	0	0	0	1
Bacteria;Bacteria_none;Proteobacteria;Alphaproteobacteria;Rhodobacterales;Rhodobacteraceae;Pacificibacter	0	0	0	0	0	0	1	1
Bacteria;Bacteria_none;Proteobacteria;Alphaproteobacteria;Rhodobacterales;Rhodobacteraceae;Palleronia-Pseudomaribius	1	0	0	0	0	0	0	1
Bacteria;Bacteria_none;Bacteroidota;Bacteroidia;Flavobacteriales;Flavobacteriaceae;Flavimarina	0	0	0	0	0	1	0	1
Bacteria;Bacteria_none;Planctomycetota;Planctomycetes;Pirellulales;Pirellulaceae;Candidatus Anammoximicrobium	0	1	0	0	0	0	0	1
Bacteria;Bacteria_none;Proteobacteria;Alphaproteobacteria;Rhodobacterales;Rhodobacteraceae;Planktotalea	0	0	0	0	1	0	0	1
Bacteria;Bacteria_none;Proteobacteria;Alphaproteobacteria;Rhodobacterales;Rhodobacteraceae;Pontivivens	0	0	0	0	0	0	1	1
Bacteria;Bacteria_none;Firmicutes;Negativicutes;Veillonellales-Selenomonadales;Selenomonadaceae;Megamonas	1	0	0	0	0	0	0	1
Bacteria;Bacteria_none;Bacteroidota;Bacteroidia;Flavobacteriales;Flavobacteriaceae;Antarcticimonas	0	0	0	0	0	0	1	1
Bacteria;Bacteria_none;Proteobacteria;Alphaproteobacteria;Rhodobacterales;Rhodobacteraceae;Roseibaca	1	0	0	0	0	0	0	1
Bacteria;Bacteria_none;Bacteroidota;Bacteroidia;Flavobacteriales;Flavobacteriaceae;Antarcticibacterium	0	0	0	0	0	1	0	1
Bacteria;Bacteria_none;Bacteroidota;Bacteroidia;Flavobacteriales;Flavobacteriaceae;Algitalea	0	0	0	1	0	0	0	1
Bacteria;Bacteria_none;Firmicutes;Clostridia;Lachnospirales;Lachnospiraceae;Vallitalea	0	0	0	0	0	1	0	1
Bacteria;Bacteria_none;Proteobacteria;Gammaproteobacteria;Burkholderiales;Oxalobacteraceae;Janthinobacterium	1	0	0	0	0	0	0	1
Bacteria;Bacteria_none;Proteobacteria;Gammaproteobacteria;Burkholderiales;Oxalobacteraceae;Massilia	1	0	0	0	0	0	0	1
Bacteria;Bacteria_none;Proteobacteria;Gammaproteobacteria;Burkholderiales;Oxalobacteraceae;Noviherbaspirillum	0	0	0	1	0	0	0	1
Bacteria;Bacteria_none;Proteobacteria;Gammaproteobacteria;Enterobacterales;Orbaceae;Orbaceae_uncultured	0	0	0	0	0	0	1	1
Bacteria;Bacteria_none;Proteobacteria;Gammaproteobacteria;Enterobacterales;Pasteurellaceae;Chelonobacter	0	0	0	0	0	0	1	1
Bacteria;Bacteria_none;Firmicutes;Clostridia;Clostridiales;Caloramatoraceae;Fonticella	1	0	0	0	0	0	0	1
Bacteria;Bacteria_none;Proteobacteria;Gammaproteobacteria;Enterobacterales;Pectobacteriaceae;Pectobacteriaceae_uncultured	0	0	0	1	0	0	0	1
Bacteria;Bacteria_none;Actinobacteriota;Coriobacteriia;Coriobacteriales;Coriobacteriales Incertae Sedis;Coriobacteriales Incertae Sedis_uncultured	0	0	0	0	0	0	1	1
Bacteria;Bacteria_none;Proteobacteria;Gammaproteobacteria;Enterobacterales;Succinivibrionaceae;Ruminobacter	0	0	0	1	0	0	0	1
Bacteria;Bacteria_none;Proteobacteria;Gammaproteobacteria;Enterobacterales;Succinivibrionaceae;Succinivibrionaceae UCG-001	0	0	0	0	0	0	1	1
Bacteria;Bacteria_none;Proteobacteria;Gammaproteobacteria;Enterobacterales;Vibrionaceae;Grimontia	0	1	0	0	0	0	0	1
Bacteria;Bacteria_none;Firmicutes;Bacilli;Lactobacillales;Lactobacillaceae;Weissella	0	0	0	0	0	1	0	1
Bacteria;Bacteria_none;Proteobacteria;Gammaproteobacteria;Enterobacterales;Vibrionaceae;Thaumasiovibrio	1	0	0	0	0	0	0	1
Bacteria;Bacteria_none;Firmicutes;Bacilli;Lactobacillales;Lactobacillaceae;Loigolactobacillus	1	0	0	0	0	0	0	1
Bacteria;Bacteria_none;Firmicutes;Bacilli;Lactobacillales;Lactobacillaceae;Limosilactobacillus	1	0	0	0	0	0	0	1
Bacteria;Bacteria_none;Proteobacteria;Gammaproteobacteria;Francisellales;Francisellaceae;Francisella	0	0	0	1	0	0	0	1
Bacteria;Bacteria_none;Proteobacteria;Gammaproteobacteria;Gammaproteobacteria Incertae Sedis;Unknown Family;Acidibacter	0	0	0	0	0	0	1	1
Bacteria;Bacteria_none;Firmicutes;Bacilli;Lactobacillales;Lactobacillaceae;Levilactobacillus	1	0	0	0	0	0	0	1
Bacteria;Bacteria_none;Proteobacteria;Gammaproteobacteria;Gammaproteobacteria Incertae Sedis;Unknown Family;Candidatus Ovatusbacter	0	0	0	1	0	0	0	1
Bacteria;Bacteria_none;Proteobacteria;Gammaproteobacteria;Gammaproteobacteria Incertae Sedis;Unknown Family;Marinicella	1	0	0	0	0	0	0	1
Bacteria;Bacteria_none;Firmicutes;Bacilli;Lactobacillales;Lactobacillaceae;Lentilactobacillus	0	0	0	1	0	0	0	1
Bacteria;Bacteria_none;Proteobacteria;Gammaproteobacteria;Halothiobacillales;Halothiobacillaceae;Halothiobacillus	1	0	0	0	0	0	0	1
Bacteria;Bacteria_none;Proteobacteria;Gammaproteobacteria;Immundisolibacterales;Immundisolibacteraceae;Immundisolibacter	0	0	0	0	0	1	0	1
Bacteria;Bacteria_none;Bacteroidota;Bacteroidia;Flavobacteriales;Flavobacteriaceae;Neptunitalea	0	0	0	0	0	0	1	1
Bacteria;Bacteria_none;Proteobacteria;Gammaproteobacteria;Methylococcales;Methylomonadaceae;Methylobacter	0	0	0	0	0	0	1	1
Bacteria;Bacteria_none;Proteobacteria;Gammaproteobacteria;Methylococcales;Methylomonadaceae;Methyloprofundus	1	0	0	0	0	0	0	1
Bacteria;Bacteria_none;Proteobacteria;Gammaproteobacteria;Methylococcales;Methylomonadaceae;Methylovulum	1	0	0	0	0	0	0	1
Bacteria;Bacteria_none;Proteobacteria;Gammaproteobacteria;Nitrosococcales;Methylophagaceae;Marine Methylotrophic Group 3	0	0	1	0	0	0	0	1
Bacteria;Bacteria_none;Firmicutes;Bacilli;Izemoplasmatales;Izemoplasmataceae;Izimaplasma	0	1	0	0	0	0	0	1
Bacteria;Bacteria_none;Proteobacteria;Gammaproteobacteria;Nitrosococcales;Nitrosococcaceae;wb1-P19	1	0	0	0	0	0	0	1
Bacteria;Bacteria_none;Proteobacteria;Gammaproteobacteria;Enterobacterales;Moritellaceae;Moritellaceae_uncultured	0	0	0	1	0	0	0	1
Bacteria;Bacteria_none;Proteobacteria;Gammaproteobacteria;Enterobacterales;Morganellaceae;Photorhabdus	0	0	0	1	0	0	0	1
Bacteria;Bacteria_none;Proteobacteria;Gammaproteobacteria;Enterobacterales;Morganellaceae;Candidatus Purcelliella	1	0	0	0	0	0	0	1
Bacteria;Bacteria_none;Proteobacteria;Gammaproteobacteria;Enterobacterales;Alteromonadaceae;Catenovulum	0	0	0	1	0	0	0	1
Bacteria;Bacteria_none;Proteobacteria;Gammaproteobacteria;Burkholderiales;Oxalobacteraceae;Oxalobacteraceae_uncultured	0	0	0	1	0	0	0	1
Bacteria;Bacteria_none;Proteobacteria;Gammaproteobacteria;Burkholderiales;Rhodocyclaceae;Azonexus	1	0	0	0	0	0	0	1
Bacteria;Bacteria_none;Proteobacteria;Gammaproteobacteria;Burkholderiales;Rhodocyclaceae;Azovibrio	0	0	0	0	0	0	1	1
Bacteria;Bacteria_none;Proteobacteria;Gammaproteobacteria;Burkholderiales;Rhodocyclaceae;Ferribacterium	0	0	0	0	1	0	0	1
Bacteria;Bacteria_none;Proteobacteria;Gammaproteobacteria;Burkholderiales;Rhodocyclaceae;Rhodocyclus	1	0	0	0	0	0	0	1
Bacteria;Bacteria_none;Proteobacteria;Gammaproteobacteria;Burkholderiales;Rhodocyclaceae;Thauera	0	0	0	1	0	0	0	1
Bacteria;Bacteria_none;Proteobacteria;Gammaproteobacteria;Chromatiales;Chromatiaceae;Halochromatium	1	0	0	0	0	0	0	1
Bacteria;Bacteria_none;Proteobacteria;Gammaproteobacteria;Chromatiales;Chromatiaceae;Thiocystis	1	0	0	0	0	0	0	1
Bacteria;Bacteria_none;Proteobacteria;Gammaproteobacteria;Chromatiales;Sedimenticolaceae;Sedimenticola	0	0	0	0	1	0	0	1
Bacteria;Bacteria_none;Proteobacteria;Gammaproteobacteria;Diplorickettsiales;Diplorickettsiaceae;Diplorickettsia	0	0	0	1	0	0	0	1
Bacteria;Bacteria_none;Proteobacteria;Gammaproteobacteria;Enterobacterales;Alteromonadaceae;Agaribacter	0	0	0	1	0	0	0	1
Bacteria;Bacteria_none;Bacteroidota;Bacteroidia;Cytophagales;Amoebophilaceae;Amoebophilaceae_uncultured	0	0	0	0	0	1	0	1
Bacteria;Bacteria_none;Proteobacteria;Gammaproteobacteria;Enterobacterales;Alteromonadaceae;Pseudobowmanella	0	0	0	1	0	0	0	1
Bacteria;Bacteria_none;Proteobacteria;Gammaproteobacteria;Enterobacterales;Morganellaceae;Candidatus Ecksteinia	0	0	1	0	0	0	0	1
Bacteria;Bacteria_none;Proteobacteria;Gammaproteobacteria;Enterobacterales;Budviciaceae;Pragia	0	0	0	1	0	0	0	1
Bacteria;Bacteria_none;Firmicutes;Clostridia;Lachnospirales;Lachnospiraceae;Hungatella	0	0	0	0	0	1	0	1
Bacteria;Bacteria_none;Firmicutes;Clostridia;Lachnospirales;Lachnospiraceae;FD2005	1	0	0	0	0	0	0	1
Bacteria;Bacteria_none;Proteobacteria;Gammaproteobacteria;Enterobacterales;Colwelliaceae;Litorilituus	0	1	0	0	0	0	0	1
Bacteria;Bacteria_none;Firmicutes;Clostridia;Lachnospirales;Lachnospiraceae;Epulopiscium	0	0	0	0	0	1	0	1
Bacteria;Bacteria_none;Proteobacteria;Gammaproteobacteria;Enterobacterales;Enterobacteriaceae;Cedecea	0	0	1	0	0	0	0	1
Bacteria;Bacteria_none;Firmicutes;Clostridia;Lachnospirales;Lachnospiraceae;Coprococcus	0	0	0	0	0	1	0	1
Bacteria;Bacteria_none;Firmicutes;Clostridia;Lachnospirales;Lachnospiraceae;CHKCI001	0	0	0	0	1	0	0	1
Bacteria;Bacteria_none;Proteobacteria;Gammaproteobacteria;Enterobacterales;Enterobacteriaceae;Mangrovibacter	1	0	0	0	0	0	0	1
Bacteria;Bacteria_none;Proteobacteria;Alphaproteobacteria;Rhodobacterales;Rhodobacteraceae;Antarctobacter	0	0	0	0	0	0	1	1
Bacteria;Bacteria_none;Proteobacteria;Gammaproteobacteria;Enterobacterales;Erwiniaceae;Izhakiella	1	0	0	0	0	0	0	1
Bacteria;Bacteria_none;Proteobacteria;Gammaproteobacteria;Enterobacterales;Erwiniaceae;Rosenbergiella	1	0	0	0	0	0	0	1
Bacteria;Bacteria_none;Proteobacteria;Gammaproteobacteria;Enterobacterales;Enterobacteriaceae;Shimwellia	1	0	0	0	0	0	0	1
